Wolf at the door
An Interactive Fiction by Ruber Eaglenest
Release 1 / Serial number 200515 / Inform 7 build 6M62 (I6/v6.33 lib 6/12N) SD

Home
You slowly open your eyes, the singing voice of your mother call you up from your slumber: "Come on, little lazy, it is time to awake! If you are late maybe you will get without breakfast!" Still half sleep you roll and roll and roll out of the bed and fall to the ground. You look around and see that your brothers and sistes are already full in their morning tasks.

On the table are a bowl of milk, a wooden spoon and two cookies.

A lone yellow cube with letters and number is forgotten in one corner of the room, next to the huge wooden chest.

You can also see a big bed and a huge wooden chest (closed) here.

>s
Sendero

* * *

>drink bowl
There's nothing suitable to drink here.

>eat cookies
(first taking Two cookies)
You eat Two cookies. Not bad.

>l
Home
You are in your natal home. Usually a cacophony of voices, plays and the rush of your mother taking care of everyone else.

On the table is a bowl of milk.

A lone yellow cube with letters and number is forgotten in one corner of the room, next to the huge chest.

* * *

>l
Home
You are in your natal home. Usually a cacophony of voices, plays and the rush of your mother taking care of everyone else.

 The grandmother clock tick-tocks next to the window and the wooden stairs.

On the table are a bowl of milk and two cookies.

A lone yellow cube with letters and number is forgotten in one corner of the room, next to the huge wooden chest.

You can also see a huge wooden chest (in which are a football ball, an umbrella, a teddy bear, a red blanket, a book, five wood blocks, a goat girl wool doll, a carton box, a wood figurine, a fake serpent, a feather and a cowbow hat) here.

>examine clock
It is a very big clock taller than your mother. It shows the time, or so the say your sisters and brothers, but you don't understand the hours yet. It has a crystal door, and behind you can see a pendulum moving constantly from side to side.

The grandmother clock is currently switched on.

>turn off clock
You switch the grandmother clock off.

>take clock
That's hardly portable.

>examine clock
It is a very big clock taller than your mother. It shows the time, or so the say your sisters and brothers, but you don't understand the hours yet. It has a crystal door, and behind you can see a pendulum moving constantly from side to side.

The grandmother clock is currently switched off.

>open clock
It isn't something you can open.

>open crystal door
You open the crystal door.

>enter door
You get into the crystal door.

In the crystal door you can see a pendulum.

>examine crystal door
In the crystal door is a pendulum.

>close door
You close the crystal door.

>examine it
In the crystal door is a pendulum.

>l
Home (in the grandmother clock)
You are in your natal home. Usually a cacophony of voices, plays and the rush of your mother taking care of everyone else.

 The grandmother clock tick-tocks next to the window and the wooden stairs.

On the table are a bowl of milk and two cookies.

A lone yellow cube with letters and number is forgotten in one corner of the room, next to the huge chest.

>out
You can't get out of the closed crystal door.

* * *

>take chest
That's fixed in place.

>showme chest
huge wooden chest - closed container
    football ball
    umbrella
    teddy bear
    red blanket
    book
    five wood blocks
    goat girl wool doll
    carton box
    wood figurine
    fake serpent
    feather
    cowbow hat
location: in Home
singular-named, improper-named; unlit, inedible, fixed in place; enterable, opaque, closed, openable, unlocked
list grouping key: none
printed name: "huge wooden chest"
printed plural name: "containers"
indefinite article: none
description: "It is ches so huge you can hide inside."
initial appearance: none
carrying capacity: 100

* * *

>out
Garden
A tidy garden that is the entrance to your home. Some lillies, fresh grass and a lemon tree, provide a fragant welcome. You can go west to the croosroads.

>examine trees
You can't see any such thing.

>w
crossroads

>w
forest1

>examine trees
You can't see any such thing.

>examine tree
You can't see any such thing.

>examine trees
You can't see any such thing.

>examine sun
The sun is shiny today. Summer is almost here.

* * *

>out
Garden
A tidy garden that is the entrance to your home. Some lillies, fresh grass and a lemon tree, provide a fragant welcome. You can go west to the croosroads.

>examine sun
The sun is shiny today. Summer is almost here.

>examine trees
You can't see any such thing.

>w
crossroads
What a splendid day bathed in the sun rays. The dirty track runs comes from the north and goes inside the forest towards the west. To the east you can return to your home.

>w
forest1

>examine trees
Trees are everywhere you look, the are closely to each other that you can barely see further. You would be lost if not for the track that crosses the whole forest.

* * *

>showme bed
big bed - supporter
location: in Home
singular-named, improper-named; unlit, inedible, fixed in place, scenery; list grouping key: none
printed name: "big bed"
printed plural name: "supporters"
indefinite article: none
description: "The big bed, where all your brothers and sistes, and your mother, sleep all together, is in a complete disarray. Your mother had no time to make the bed because you slept till very late."
initial appearance: none
carrying capacity: 100

>enter bed
That's not something you can enter.

* * *

>examine clock
It is a very big clock taller than your mother. It shows the time, or so the say your sisters and brothers, but you don't understand the hours yet.

 It has a crystal door, and behind you can see a pendulum moving constantly from side to side. Also, it emits a constant tick, tock, tick, tock, tick, tock... times passes.

>turn off clock
You would not know how to stop the clock.

>touch pendulum
The crystal door isn't open.

>stop pendulum
That's not a verb I recognise.

>open door
You open the crystal door.

>move pendulum
Nothing obvious happens.

>actions
Actions listing on.

>move pendulum
[pushing the pendulum]
Nothing obvious happens.
[pushing the pendulum - succeeded]

* * *

>examine clock
It is a very big clock taller than your mother. It shows the time, or so the say your sisters and brothers, but you don't understand the hours yet.

 It has a crystal door, and behind you can see a pendulum moving constantly from side to side. Also, it emits a constant tick, tock, tick, tock, tick, tock... times passes.

>touch pendulum
The crystal door isn't open.

>move pendulum
The crystal door isn't open.

>enter clock
That's not something you can enter.

>open door
You open the crystal door.

>touch pendulum
You extend your paw expenctantly and... you touch the pendulum: it goes out of its momentu, slowing by the moment until it stops moving completely.

>examine clock
It is a very big clock taller than your mother. It shows the time, or so the say your sisters and brothers, but you don't understand the hours yet. It has a crystal door, and behind you can see a pendulum that is currently stop in place. The clock has stopped doing its tick-tock sound. You wonder if you have already stopped the whole time so you never grow up.

The grandmother clock is currently switched off.

>turn on clock
You would not know how to stop the clock.

>move pendulum
You give it a tentatively push with your paw... and the pendulum start moving from side to side, and now, never stops moving.

>examine clock
It is a very big clock taller than your mother. It shows the time, or so the say your sisters and brothers, but you don't understand the hours yet. It has a crystal door, and behind you can see a pendulum moving constantly from side to side. And it emits a constant tick, tock, tick, tock, times passes.

The grandmother clock is currently switched on.

>push pendulum
You give a little push, following the momentum of the pendulum, but the extra push makes it goes astray, and after some erratical movements, slowly it comes to a complete stop.

>touch pendulum
You extend your paw ecxpenctantly and... you touch the pendulum. Nothing happens, it is still unmoved.

* * *

>examine clock
It is a very big clock taller than your mother. It shows the time, or so the say your sisters and brothers, but you don't understand the hours yet.

 It has a crystal door, and behind you can see a pendulum moving constantly from side to side. Also, it emits a constant tick, tock, tick, tock, tick, tock... times passes.

>eat cookies
First, you must be seated at the table. On your chair.

>climb chair
You get onto your chair.

>examine chair
Your chair seems imposibly tall, but you have aready learned to climb on the top of it, and it allows you, at least, to peep your head over the table, and in that way, proceed to eat.

>enter chair
But you're already on your chair.

>actions climb chair
I only understood you as far as wanting to actions.

>actions
Actions listing on.

>climb chair
[climbing your chair]
[(1) entering your chair]
But you're already on your chair.
[(1) entering your chair - failed the can't enter what's already entered rule]

[climbing your chair - failed the can't enter what's already entered rule]

>actions off
Actions listing off.

>drink milk
You take a sip of the milk, now colder, but still fresh and tasty! Your mother milk herself every morning, so you still take the nutrients you need, but both of you already started the  Delicious.

>drink bowl
You take another sip.
 Delicious.

>actions
Actions listing on.

>drink bowl
[drinking the bowl of milk]
You take another sip.
 Delicious.
[drinking the bowl of milk - failed]

>examine table
[examining the table]
The long table that have space for all the meals of all your sisters and brothers.

On the table are a bowl of milk, a wooden spoon and two cookies.

[examining the table - succeeded]

>drink bowl
[drinking the bowl of milk]
You take another sip.
 Delicious.
[drinking the bowl of milk - failed]

>taste cookies
[tasting two cookies]
You taste nothing unexpected.
[tasting two cookies - succeeded]

>actions off
Actions listing off.

>eat cookie
You can't see any such thing.

>eat cookies
(first taking two cookies)
Your favourites! You eat half of one in just one bite, and throw the other half inside the bowl. The proceed to take the remaining one and submergue almost completly, wetting your paw. You linger for a moment there, not too much, so the cookie get too wet and disolves itself in the milk, then proceed to put that half wet cookie in your mouth. You close your eyes. Yummmy... You repeat the process with the remaining other half of the last cookie: half deep in the bowl, wet for some seconds, and to your mouth. Then you hunt for the remains of the delicous dough with the wooden spoon, and to finalize, you quaff down the remain of the milk in three qualffs, remains of the cookies included. With a smile, you leave the empty bown on the table. And with the sweet heaviness in your belly, you climb down from the chair.

Home
You are in your natal home. Usually a cacophony of voices, plays and the rush of your mother taking care of everyone else.

 The grandmother clock tick-tocks next to the window and the wooden stairs.

On the table are an empty bowl and a wooden spoon.

A lone yellow cube with letters and number is forgotten in one corner of the room, next to the huge wooden chest.

You can also see a big bed and a huge wooden chest (closed) here.

* * *

>eat cookies
First, you must be seated at the table. On your chair.

* * *

>climb chair
You get onto your chair.

>eat cookies
(first taking two cookies)
Your favourites! You eat half of one in just one bite, and throw the other half inside the bowl. The proceed to take the remaining one and submergue almost completly, wetting your paw. You linger for a moment there, not too much, so the cookie get too wet and disolves itself in the milk, then proceed to put that half wet cookie in your mouth. You close your eyes. Yummmy... You repeat the process with the remaining other half of the last cookie: half deep in the bowl, wet for some seconds, and to your mouth. Then you hunt for the remains of the delicous dough with the wooden spoon, and to finalize, you quaff down the remain of the milk in three qualffs, remains of the cookies included. With a smile, you leave the empty bown on the table. And with the sweet heaviness in your belly, you climb down from the chair.

>eat cookies
You can't see any such thing.

>examine table
The long table that have space for all the meals of all your sisters and brothers.

On the table are an empty bowl and a wooden spoon.

>open chest
You open the huge wooden chest, revealing a football ball, an umbrella, a teddy bear, a beige blanket, a book, five wood blocks, a goat girl wool doll, a carton box, a wood figurine, a fake serpent, a red cape, a feather, a cowbow hat and a forgotten cookie.

>examine cookie
Your favourites! A lost one!

>eat cookie
(first taking the forgotten cookie)
You gulp down the cookie. It is very bland. Oh, oh! Your belly start aching.

>eat cookie
You can't see any such thing.

* * *

>purloin the iron key
[Purloined.]

>open chest
It seems to be locked.

>unlock chest with key
You unlock the huge wooden chest.

>open chest
You open the huge wooden chest, revealing a football ball, an umbrella, a teddy bear, a beige blanket, a book, five wood blocks, a goat girl wool doll, a carton box, a wood figurine, a fake serpent, a red cape, a feather, a cowboy hat and a forgotten cookie.

>lock chest
What do you want to lock the huge wooden chest with?

>key
First you would have to close the huge wooden chest.

>close chest
You close the huge wooden chest.

>lock chest
What do you want to lock the huge wooden chest with?

>key
You lock the huge wooden chest.

>throw the key
Dropped.

>take chair
That's hardly portable.