Tuulen Ukko tuulen Akka
 Tuulen kaikki ristikansa

Miestä mustoa rukoilen
 Suuren tuulen nostajaksi --

-- Tuuli, Hedningarna

"They say witches tell the stories that matter. Such is the will of the gods.
 So listen. I am Lenne. I am the witch. This is the story."

Tuuli (English)
An interactive ritual by Daurmith and Ruber Eaglenest
Release 3 / Serial number 180501 / Inform 7 build 6M62 (I6/v6.33 lib 6/12N) SD

[If this is your first time playing interactive fiction type HELP for more information.]

In Mákke's hut
You wake in your pallet, the scream still scratching at your throat.

You go to Mákke's bed to tell her about your dream. She isn't there, and you know she's dead even before you know where she is. The room is black as her eyes. Cold as her bones. Empty as her body. 

Her biggest treasure, the small carved ivory chest, lies forgotten in a corner.

>examine knife
You can't see any such thing.

>open chest
You open the small chest, revealing the knife of Mákke, an oil flask and a sponge.

>examine knife
The knife of Mákke. Small, but sharp as a witch mind. It has a black stone blade, always cold to the touch. You have always been fascinated by the translucent quality of the stone, the pale gold reflections you can glimpse inside it.

>take knife
Taken.

>examine knife
You watch the black knife covered with Mákke's black witch blood in your hand. And remember her teachings about it: "the blade tears as much as it conjoins, attaches as well as it stabs."

The knife of Mákke. Small, but sharp as a witch mind. It has a black stone blade, always cold to the touch. You have always been fascinated by the translucent quality of the stone, the pale gold reflections you can glimpse inside it.

>examine knife
The knife of Mákke. Small, but sharp as a witch mind. It has a black stone blade, always cold to the touch. You have always been fascinated by the translucent quality of the stone, the pale gold reflections you can glimpse inside it.

>examine knife
The knife of Mákke. Small, but sharp as a witch mind. It has a black stone blade, always cold to the touch. You have always been fascinated by the translucent quality of the stone, the pale gold reflections you can glimpse inside it.

* * *

>test allgame
(Testing.)

>[1] go out
As you get outside you feel the cold of the snow through your boots.

In the village
The village sleeps in the cold hour before dawn. The sun is still down, but there's already light behind the horizon, bathing the night's snow in a eerily glowing white.

A path nearly covered by snow comes from the beach at the west and continues northwards, climbing the mountain.

Mákke's hut is here, set slightly apart from the rest but still within the village's limits.

>[2] examine floor
You can see Mákke's prints in the snow, her small feet staggering northwards.

>[3] n

Path
The narrow path leading from the village to the cliff is barely a trail in the snow. Goats use it to chew the hardy grasses growing on the wind-swept heights, and witches use it to go the black stone to perform rituals of winter and spring, of life and death. It winds its way up north along the mountain's slope to get to the cliff's edge. To the south, it reaches the village.

>[4] n

Cliff
A small flat extension which drops precipitously to the sea in its west side. Leaning out you can see the rocks of the nearly-vertical rock wall and the albatrosses' nests, turning the stones white with their droppings. There's little to see here: down is the small bay by the village, and the hostile sea to the west and north. And, of course, the witch stone.

Mákke's sealskin cloak lies on the ground by the black stone. You don't know if it was left there or the wind blew it there.

>[5] x snow
Mákke's tracks take you to the cliff's edge. She stopped there. Just at the very edge there's a patch of trampled snow and the tracks end.

>[6] x rocks
You peer down cautiously, careful of the treacherous gusts that could make you fall. You can see the albatrosses' nests and the stones barely covered in some moss and dry plants.

Mákke has fallen down the cliff but hasn't reached the sea. You can see her body on the white stones, amidst the albatrosses' nests. Her eyes are open and full of snow and her hand holds an empty wineskin. Her mouth is fear.

You must speak to Árvet about the nightmare and Mákke's death. Because you know what's coming, what you must do next. And you fear it as you have never feared anything before.

Please press SPACE to continue.

* * *

>e
You can't go that way.

>l
Cliff
Una pequeña explanada que cae vertiginosamente hasta el sea, hacia el oeste. Si te asomas verás las rocks de la pared casi vertical, donde anidan los albatross que han blanqueado las peñas con sus excrementos. Hay poco que ver desde aquí: la pequeña bay de la Village down, la extensión hostil del sea al oeste y al norte, el Path que retorna a la Village hacia el sur, la snow que lo cubre todo. Y la stone, la stone de las brujas.

On the black stone is the body of Mákke.

El mantle de piel de foca de Mákke está tirado a un lado de la black stone. No sabes si dejado allí o arrastrado por el wind.

>s
Path
El estrecho Path que lleva desde la Village al Cliff es apenas un trazo en la snow. Las cabras lo usan cuando van a ramonear las hierbas duras que crecen en la planicie barrida por el wind, y las brujas lo usan cuando van a la black stone en la que realizan los rituales de invierno y primavera, de vida y de death. Hacia el norte, asciende serpenteante por la ladera de la mountain hasta llegar a la cima del Cliff. Hacia el sur retorna a la Village.

>s
In the village
Una treintena de endebles huts forman la Village. Algunas no son más que unas cuantas tablas y tejado de ramas y hojas trenzados. Otras son casas más sólidas, recuerdo de épocas más prósperas, hechas con grandes troncos y selladas con barro y corteza de abedul. De vez en cuando se ve un huertecillo en vez de una casa, o un corral con cabras que miran altivas a su alrededor. Un mantle de snow caído durante toda la noche cubre toda superficie.

 Un Path casi tapado por la snow viene desde la Beach en el oeste y continúa hacia el norte, trepando la mountain.

 La hut de Mákke está aquí, algo apartada del resto aunque integrada en la Village.

>enter
You must supply a noun.

>take all
There are none at all available!

>enter hut
En la hut de Mákke
La hut no es diferente a las demás de la Village: paredes de troncos sellados con barro y corteza y una única sala con suelo de tierra apisonada. Has pasado más tiempo en esta habitación que en casa de tus padres y la conoces mejor que la palma de tu hand; una tosca mesa de trabajo, la bed de Mákke y tu jergón, además de algunos enseres cotidianos y algunas hierbas secas que os quedan de la colecta de primavera. Los pocos tesoros que Mákke apreció en vida parecen poca cosa tras su death: el arcón de madera pintada, el pequeño altar con las runas rituales.

Su mayor tesoro, el small chest de seafil tallado, permanece olvidado en un rincón.

>take all
small chest: Taken.

>out
In the village
Una treintena de endebles huts forman la Village. Algunas no son más que unas cuantas tablas y tejado de ramas y hojas trenzados. Otras son casas más sólidas, recuerdo de épocas más prósperas, hechas con grandes troncos y selladas con barro y corteza de abedul. De vez en cuando se ve un huertecillo en vez de una casa, o un corral con cabras que miran altivas a su alrededor. Un mantle de snow caído durante toda la noche cubre toda superficie.

 Un Path casi tapado por la snow viene desde la Beach en el oeste y continúa hacia el norte, trepando la mountain.

 La hut de Mákke está aquí, algo apartada del resto aunque integrada en la Village.

>n
Path
El estrecho Path que lleva desde la Village al Cliff es apenas un trazo en la snow. Las cabras lo usan cuando van a ramonear las hierbas duras que crecen en la planicie barrida por el wind, y las brujas lo usan cuando van a la black stone en la que realizan los rituales de invierno y primavera, de vida y de death. Hacia el norte, asciende serpenteante por la ladera de la mountain hasta llegar a la cima del Cliff. Hacia el sur retorna a la Village.

>n
Cliff
Una pequeña explanada que cae vertiginosamente hasta el sea, hacia el oeste. Si te asomas verás las rocks de la pared casi vertical, donde anidan los albatross que han blanqueado las peñas con sus excrementos. Hay poco que ver desde aquí: la pequeña bay de la Village down, la extensión hostil del sea al oeste y al norte, el Path que retorna a la Village hacia el sur, la snow que lo cubre todo. Y la stone, la stone de las brujas.

On the black stone is the body of Mákke.

El mantle de piel de foca de Mákke está tirado a un lado de la black stone. No sabes si dejado allí o arrastrado por el wind.

>open chest
You open the small chest, revealing the knife of Mákke, an oil flask and a sponge.

Ya tienes todos los elementos necesarios en tu poder. Es hora de preparar a Mákke.

>test prepara
(Testing.)

>[1] x makke
Mákke está fría y rígida, en una pose grotesca con los brazos y las piernas contraídas en un espasmo de death. Mákke posee la rune of Akka en su piel, debajo de la clothes oscura, humedecida, con snow acumulada en los pliegues.

>[2] rub makke
Frotas los brazos y las piernas de Mákke hasta que puedes moverla. Le quitas la snow de la cara y le cierras los ojos aún húmedos.

>[3] x makke
Mákke reposa en toda su pequeña extensión sobre la black stone. Mákke posee la rune of Akka en su piel, debajo de la clothes oscura aún mojada.

>[4] cut cloth with knife
(first taking the knife of Mákke)
Cortas las ropas con el knife de hoja negra de Mákke. Te resulta extraño darte cuenta de que Mákke muerta parece más pequeña que Mákke viva. Descartas las ropas a un lado.

>[5] x makke
Mákke está desnuda sobre la black stone. Su piel arrugada y mojada está sucia de vivir, y esa suciedad se ha quedado impregnada a su carne muerta. Hay restos de sangre donde su cuerpo impactó contra las rocks. La rune of Akka está tatuada sobre su pecho.

>[6] anoint makke with oil
(first taking the oil flask)
Tomas el flask de aceite, el aceite aromatizado con resinas y plantas que Mákke sabía preparar, y le untas la piel blanda, las manos duras, el cuerpo entero que tan bien le ha servido. Con la sponge frotas los restos de vida de su cuerpo muerto hasta que su piel pierde el olor de la death y se llena del olor a pinos y a invierno y al aire limpio del sea.

>[7] x makke
Mákke ya ha sido ungida y lavada para entrar en la otra vida. Sobre el pecho de Mákke, sobre el lugar de la fuerza del alma, está la rune of Akka.

>[8] cut the akka rune with knife
Haces lo que tienes que hacer y luego cubres el cuerpo de Mákke con su mantle de piel de foca. Pero dejas la sangre muerta de Mákke en el knife de black stone.

Please press SPACE to continue.

* * *

>recite
No pides permiso a Árvet. No pides permiso al espíritu de Mákke. Los vivos son de la vida. Los muertos son de la death.

 Las brujas no son de ningún sitio.

Destapas el wineskin y lo ofreces al sea.

 Tuulen Ukko tuulen Akka
 Tuulen kaikki ristikansa
 
 Miestä mustoa rukoilen
 Suuren tuulen nostajaksi
 
El wind comienza a soplar fuerte, agitando y levantando las olas.

>recite
La vieja lengua se enreda en tu garganta y en los dientes, vuelve el aire denso a tu alrededor. Sigues pronunciando el conjuro mientras el arm que sujeta el wineskin va pesando más y más.

 Suuren tuulen nostajaksi
 Sään rajun rakentajaksi
 
 Tuopa taita tammen latvat
 Rutaise rutiset raijat
 
El wind redobla sus fuerzas y atrae nubes grises que amenazan storm. Las olas alcanzan velocidad y altura y se estrellan contra el Cliff en frías nubes de espuma.

>recite
El wineskin empieza a hincharse, poco a poco al principio. Los pliegues del cuero se alisan. A lo lejos, el cielo se oscurece. La storm hace que se torne negro, del mismo color que los barcos en el horizon. El arm te duele, tiembla. La cabeza también te duele, con un dolor sordo y pulsante. Te cuesta seguir pronunciando el conjuro. El aire sabe a sal y a hierro.

 Nouse tuuli tuulemahan
 Vihkurit vetelemään
 
 Nouse tuuli tuulemahan
 Ilseainta riehkimään
 
El wind ruge con fuerza amenazando con arrancarte el wineskin del arm. Las olas alcanzan gran altura e intentan derribar el Cliff acometida tras acometida. Una lluvia intensa cae de las nubes oscuras y airadas. Los barcos negros cabecean entre las ráfagas y se apresuran a arriar las velas por miedo a perderlas.

>g
Tu voz llega desde fuera también, un eco extraño y estridente, mientras la luz va desapareciendo tragada por nubes negras que vienen desde los cuatro puntos cardinales. El aire sopla frío y a golpes, dando latigazos a las olas que lamen la orilla, down en la bay. El wineskin está hinchado y pesa como un ahogado. Te cuesta respirar cada vez más: el aire parece water densa y salobre.

 Tuule tuuli kuusi vuotta
 Seuro seitsemän kesää
 
 Itse kuoho kosken lailla
 Sekä valtona vallitse
 
Las olas y la lluvia se unen en un todo enloquecido, incesante, insensato. Todo se ahoga bajo el water. Las mismas rocks del Cliff tiemblan, se desmoronan, se rinden. Los relámpagos cortan el horizon en dos. El rugir del wind amenaza con tirarte Cliff down. La furia de los elementos es tal que sabes que la flota de black ships pronto estará condenada.

>g
Esperas; esperas hasta que la storm en tu cabeza y la storm en el horizon son una, hasta que tu cuerpo está en dos sitios a la vez, hasta que el wineskin casi se escapa tironeando de tus dedos en su ansia por liberar la furia del wind.

 Pero aún no. Aún no. El poder saldrá de tus palabras y de tu voluntad, no con la furia ciega de la storm.

 Miestä mustoa rukoilen
 Suuren tuulen nostajaksi
 
 Pero la rune of Akka no responde. No sientes su energía. Algo falla. Lo que más temías: tú. No eres una bruja. Solo eres una muchacha tonta que roba el poder a su maestra muerta. La rune no puede responder porque no está en tu piel. No tiene sangre de bruja que la alimente.

 Con la otra hand tomas la rune que había estado en la piel de Mákke y la colocas sobre el arm que sujeta el wineskin. No es la manera habitual, no es la manera correcta. Pero la decisión es tuya. Si realmente eres la bruja, si eres digna del poder, lo que hagas será lo que debe hacerse. Eso decía Mákke.

 El desánimo crece en ti y de la misma manera notas como el conjuro decrece en intensidad.

>g
Repites de nuevo los versos finales:

 Miestä mustoa rukoilen
 Suuren tuulen nostajaksi
 
¡No funciona! La rune no forma parte de ti. No va a funcionar. Gritas tu frustración al wind.

>stab akka rune with knife
I only understood you as far as wanting to stab the rune of Akka.

>stab rune of akka with knife
I only understood you as far as wanting to stab the rune of Akka.

>stab the rune of akka
Tomas el knife con la sangre de Mákke. En tu mente la storm ya ruge, te destroza. Arriba, las nubes esperan tu orden.

 Miestä mustoa rukoilen
 Suuren tuulen nostajaksi
 
 Gritas y el wind ruge contigo. Alzas el knife y el cielo entero se alza contigo. Dejas caer el knife y la hoja de black stone atraviesa la piel de Mákke, la rune of Akka, tu propio arm. La sangre muerta de Mákke se mezcla con tu sangre viva. Tus dedos quieren abrirse, soltar el wineskin, pero el arm continúa extendido, goteando sangre sobre la black stone.

 Suuren tuulen nostajaksi
 Sään rajun rakentajaksi
 
El infierno hecho water, wind y trueno se ha desatado sobre la bay. La galerna ya está aquí. Se arremolina sobre la stone de las brujas y arranca violentamente el cuerpo de la bruja Mákke. Vuela y gira como una muñeca de trapo llevada por la storm, perdiéndose en la lluvia.

El wineskin estalla en wind y furia, se rompe en mil pedazos, y a lo lejos la storm vuelve el cielo del color aseaillo de un cadáver. El conjuro sigue saliendo de tus labios como la sangre de tu arm, guiando la storm, guiando la death hacia los barcos negros. Tus ojos se llenan de ahogados, tu nariz de water, tu boca de sangre. Eres la storm. Eres la death. Y mueres por primera vez en tu vida.

Please press SPACE to continue.

Soy Lenne. Soy la bruja. Esta es mi historia.

 Despiertas en el suelo, con el arm aún atravesado por el knife. Tu hand está cubierta de sangre y hielo. Del wineskin no queda ni un pedazo. Tampoco se ve el cuerpo de la bruja Mákke.

 Árvet está en la orilla cuando bajas, débil y dolorida, sujetándote un bandage al arm herido.

En la Beach.
Una estrecha lengua de dark pebbles es la salida del pueblo al sea. A ambos lados los piers para las barcas delimitan una pequeña bay de aguas frías y desapacibles. Hacia el este descansa la Village.

La Beach de stones oscuras está cubierta de lumber, de cordaje y de cadáveres. Habían sido hombres altos, de pelo aseaillo o cobrizo, pálidos y orgullosos. Muchos llevan al cinto espadas y hachas. Ahora no son más que carne para el festín de los albatross.

Árvet, el jefe, está aquí.

-Has llamado a la storm, bruja Lenne,- dice Árvet.

>talk to arvet
[1] ...
[2] Terminar la Conversation.

>1
Casi no puedes hablar: tu garganta está en carne viva y quemada por la sal y por el wind. Miras a los muertos.

[1] "Se llamaba Leif."
[2] "Se llamaba Ulrif."
[3] "Se llamaba Snorri."
[4] Terminar la Conversation.

>1
-Se llamaba Leif-, dices, con voz como el graznido de un cuervo. -Tomó mujer la primavera pasada, la dejó encinta antes de subir al barco negro. Pasó el viaje tallando un juguete para su bebé en un diente de morsa.

 Árvet no dice nada.

[1] "Se llamaba Ulrif."
[2] "Se llamaba Snorri."
[3] Terminar la Conversation.

>1
Das la vuelta con el pie a otro muerto para mirarle los ojos blancos, la cara hinchada.

 -Se llamaba Ulrif-, dices. -Le gustaba beber y le gustaba pelear. Cantaba mejor que nadie en su Village y pegaba a su mujer cuando llegaba borracho a casa y ella no quería yacer con él.

[1] "Se llamaba Snorri."
[2] Terminar la Conversation.

>1
Un poco más lejos un hombre mira al cielo con un solo ojo.

 -Se llamaba Snorri-, dices. -No era de la Village; vino de lejos, mercadeando con pieles, y se quedó con ellos. Era cruel. Le gustaba navegar y le gustaba matar, y hubiera querido ser jefe. Pasó el viaje soñando con los screams de las mujeres que toseaía por la fuerza al llegar.

[1] Terminar la Conversation.

>1
Tu mirada sigue perdida entre los muertos.

>z
Time passes.

>z
Time passes.

>z
Time passes.

-La Village vive-, dice Árvet.

 No dice lo que tú has aprendido: que la bruja paga por la sangre vertida. Ahora posees para siempre sus deaths y sus vidas, mueres cada vez que matas. Pero hay mucha death en la Beach. Mucha sangre en esta tierra.

>z
Time passes.

>talk to arvet
Te giras hacia la Village.

-La Village vive-, dices.

 Quizá Lenne la muchacha hubiera llorado. Pero Lenne, la bruja, ya no pudo.

 Soy Lenne. Soy la bruja. Esta ha sido la historia. A través de todos los años, de todos los muertos y de toda la sangre aún recuerdo aquel momento en la Beach, entre los cadáveres.

 Miré en silence a Árvet; no pude asegurarle que la vida volvería, que el pescado caería en las redes, que los niños tendrían leche y los hombres carne de foca y arenque. Todo lo que vi era la death que rodea la tierra, que llenaba el sea. No pude ver para la Village la vida que quise salvar con la death que invoqué.

 Quizá Mákke lo sabía. Quizá por eso flaqueó y murió antes de poder traer la storm. Quizá hubiera sido mejor morir por la espada y el hacha que desaparecer poco a poco.

 Árvet me miró como se mira a las brujas: con respeto, con miedo. Con odio. Yo miraba los muertos.

 A través del bandage de mi arm salía sangre, y era sangre negra.

 Sangre de bruja.

    *** The End ***

Would you like to RESTART, RESTORE a saved game, QUIT or UNDO the last command?

* * *

>perform ritual
You don't ask permission from Árvet. You don't ask permission from Mákke. No pides permiso a Árvet. No pides permiso al espíritu de Mákke. The living belong to Life. The dead belong to Death.

 Witches belong nowhere.

You uncork the wineskin and offer it up to the wind.

 Tuulen Ukko tuulen Akka
 Tuulen kaikki ristikansa
 
 Miestä mustoa rukoilen
 Suuren tuulen nostajaksi
 
The wind starts blowing, making the waves rise.

>perform spell
The old tongue grabs at your throat and teeth, turns the air thick around you. You keep on reciting the spell as you feel the arm holding the wineskin grow heavy.

 Suuren tuulen nostajaksi
 Sään rajun rakentajaksi
 
 Tuopa taita tammen latvat
 Rutaise rutiset raijat
 
The wind howls now, bringing grey clouds that already tell of the coming storm. The waves come in stronger and faster, smashing against the cliff in cold, white foam.

>g
The wineskin fills up, slowly at first. The folds in the leather smooth out. Far away the sky darkens. The storms is turning it black, as the ships coming upon the horizin. Your arm hurts and shakes. Your head hurts too, a dull and pounding ache. Reciting the spell is getting harder every instant. There's a taste of salt and iron in the air.

 Nouse tuuli tuulemahan
 Vihkurit vetelemään
 
 Nouse tuuli tuulemahan
 Ilseainta riehkimään
 
Th wind roars trying to tear the wineskin off your arm. The high waves pound the cliff as if trying to bring it down. Rain pours from the angry dark clouds. The black ships buck and yaw against the gale and the rain. They've gathered sails, so that the wind does not rip them to shreds.

>g
Your own voice seems to be coming from outside yourself: a strange, shrill echo. The light is being eaten by the black clouds closing over your head. the wind is cold and gusty, whipping the waves that lap the bay's stones. The wineskin is swollen, heavy as a drowned man. You have trouble breathing: the very air entering your lungs feels like thick, briny water.

 Tuule tuuli kuusi vuotta
 Seuro seitsemän kesää
 
 Itse kuoho kosken lailla
 Sekä valtona vallitse
 
Waves and rain blend together in a crazed whirl. Everything disappears under the water. Even the cliff stones shake and tumble and surrender. Lightning slashes the sky apart. The wind roars and threatens to throw you down the cliff. The fury of the elements is such that you know the black ships will soon be doomed.

>g
You wait; you wait until the storm inside your head and the storm in the sky are one, until your body is in two places at once, until the wineskin nearly flies from your grip, trying to release the fury of the winds.

 But no. Not yet. The power will flow obeying your words and your will, not the blind fury of the storm.

 Miestä mustoa rukoilen
 Suuren tuulen nostajaksi
 
 But the rune of Akka doesn't respond. You can't feel its energy. Something's wrong. And you know what it is: youself, as you feared. You are not a witch. You're just a foolish girl stealing power from her dead teacher. The rune cannot respond to the spell because the rune is not on your skin. It has no witch blood to feed from.

 With your free hand you take the piece of Mákke's skin with the rune and place it upon the arm holding the wineskin. It's not the usual way; it's not the right way. But it's your call. If you really are the witch, if you are worthy of the power, what you end up doing will be what must be done. That's what Mákke said.

 Despair growns inside you and you feel the spell's strenght waning accordingly.

>g
Again you recite the final lines:

 Miestä mustoa rukoilen
 Suuren tuulen nostajaksi
 
It's not working! The rune is not part of you. It's never going to work. You scream your frustration at the storm. The rune is still not a part of you.

>stab rune with knife
(the rune of Akka with the knife of Mákke)
You take the knife carrying Mákke's blood. In your mind the storm is already wild, tearing at you. Up above, the clouds wait for your command.

 Miestä mustoa rukoilen
 Suuren tuulen nostajaksi
 
 You scream and the wind roars with you. You raise the knife and the sky itself rises with you. And you bring down the knife: the black stone blade stabs Mákke's skin, Akka's rune, your own arm. Mákke's dead blood mixes with your own living blood. Your fingers want to open, want to drop the wineskin; but still you hold out your arm, dripping blood on the witch stone.

 Suuren tuulen nostajaksi
 Sään rajun rakentajaksi
 
Hell is now over the bay, made from water and wind and thunder. The squall is right over you. It roars over the witch stone, snatching Mákke's body violently. It tumbles away, broken and unstrung amidst the storm, and disappears into the slashing rain.

The wineskin explodes in wind and fury, bursts into shreds, and the storm turns the sky yellow like a cadaver. The spell issues from your lips like blood from your arm, directing the storm, bringing death to the black ships. Your eyes fill with drowned men, your nose fills up with water, your mouth is full of blood. You are the storm. You are death. You die for the first time in your life.

Please press SPACE to continue.

I am Lenne. I am the witch. This is my story.

 You wake up on the ground, your arm still pierced by the knife. Your hand is covered in blood and ice. There's no sign of the wineskin. There's no sign of Mákke's body either.

 When you get down, weak and hurt, tying a bandage over your wounded arm, you see Árvet there on the beach.

On the beach.
A narrow tongue of dark pebbles is the village's exit to the sea. In each side, the wooden piers for the fishing boats define a small bay of cold and restless waters. To the east the village still rests.

The dark pebble beach is covered with lumber, rigging and corpses. They had been tall men with yellow or reddish hair. Pale, proud men. Many of them carry swords or axes. Now they are just meat of the albatrosses" feast.

Chief Árvet is here.

"You have called forth the storm, witch Lenne," Árvet says.

* * *

>summon
You don't ask permission from Árvet. You don't ask permission from Mákke. The living belong to Life. The dead belong to Death.

 Witches belong nowhere.

You uncork the wineskin and offer it up to the wind.

 Tuulen Ukko tuulen Akka
 Tuulen kaikki ristikansa
 
 Miestä mustoa rukoilen
 Suuren tuulen nostajaksi
 
The wind starts blowing, making the waves rise.

>summon
The old tongue grabs at your throat and teeth, turns the air thick around you. You keep on reciting the spell as you feel the arm holding the wineskin grow heavy.

 Suuren tuulen nostajaksi
 Sään rajun rakentajaksi
 
 Tuopa taita tammen latvat
 Rutaise rutiset raijat
 
The wind howls now, bringing grey clouds that already tell of the coming storm. The waves come in stronger and faster, smashing against the cliff in cold, white foam.

>summon
The wineskin fills up, slowly at first. The folds in the leather smooth out. Far away the sky darkens. The storm is turning it black, black as the ships coming upon the horizon. Your arm hurts and shakes. Your head hurts too, a dull and pounding pain. Reciting the spell is getting harder by the moment. There's a taste of salt and iron in the air.

 Nouse tuuli tuulemahan
 Vihkurit vetelemään
 
 Nouse tuuli tuulemahan
 Ilseainta riehkimään
 
The wind roars trying to tear the wineskin off your arm. The high waves pound the cliff as if trying to bring it down. Rain pours from the angry dark clouds. The black ships buck and yaw against the gale and the rain. They've gathered sails, so that the wind does not rip them to shreds.

>summon
Your own voice seems to be coming from outside yourself: a strange, shrill echo. The light is being eaten by the black clouds closing over your head. the wind is cold and gusty, whipping the waves that lap the bay's stones. The wineskin is swollen, heavy as a drowned man. You have trouble breathing: the air entering your lungs feels like thick, briny water.

 Tuule tuuli kuusi vuotta
 Seuro seitsemän kesää
 
 Itse kuoho kosken lailla
 Sekä valtona vallitse
 
Waves and rain blend together in a crazed whirl. Everything disappears under the water. Even the cliff stones shake and tumble and surrender. Lightning slashes the sky apart. The wind roars and threatens to throw you down the cliff. The fury of the elements is such that you know the black ships will soon be doomed.

>summon
You wait; you wait until the storm inside your head and the storm in the sky are one, until your body is in two places at once, until the wineskin nearly flies from your grip, trying to release the fury of the winds.

 But no. Not yet. The power will flow obeying your words and your will, not the blind fury of the storm.

 Miestä mustoa rukoilen
 Suuren tuulen nostajaksi
 
 But the rune of Akka doesn't respond. You can't feel its energy. Something's wrong. And you know what it is: youself, as you feared. You are no witch. You're just a foolish girl stealing power from her dead teacher. The rune cannot respond to the spell because the rune is not on your skin. It has no witch blood to feed from.

 With your free hand you take the piece of Mákke's skin with the rune and place it upon the arm holding the wineskin. It's not the usual way; it's not the right way. But it's your call. If you really are the witch, if you are worthy of the power, what you end up doing will be what must be done. That's what Mákke said.

>summon
Again you recite the final lines:

 Miestä mustoa rukoilen
 Suuren tuulen nostajaksi
 
It's not working! The rune is not part of you. It's never going to work. You scream your frustration at the storm. The rune is still not a part of you.

>summon
Again you recite the final lines:

 Miestä mustoa rukoilen
 Suuren tuulen nostajaksi
 
It's not working! The rune is not part of you. It's never going to work. You scream your frustration at the storm. The rune is still not a part of you.

>z
Time passes.

>z
Time passes.

Despair growns inside you and you feel the spell's strenght waning accordingly.

>z
Time passes.

The storm is losing strength. The clouds seem to have already unloaded all their rain and turn gray instead of black.

>z
Time passes.

The clouds disperse and the waves stop pounding the cliff.

>z
Time passes.

The wind has weakened and the waves slow down to their usual strength.

>summon
You have lost all your borrowed power. The wineskin loses energy and your words lose their capacity to alter the fabric of existence.

It's over. The wineskin empties of the last of its wind and the clouds disperse. The sea is calm again. On the horizon you can see the black ships rising their banners and coming closer and closer. 

    *** You could not call forth the storm and your village will die at the hands of the men of the black ships. ***

Would you like to RESTART, RESTORE a saved game, QUIT or UNDO the last command?

* * *

>z
Time passes.

>z
Time passes.

The lightning has stopped looking for the black ships. And one lightning strikes near the witches' stone. Too close. The huge noise makes you almost deaf. A warning. Perhaps all this has been nothing more than an offense to the gods and your teacher.

>z
Time passes.

Despair growns inside you and you feel the spell's strenght waning accordingly. You look at the rune of Akka, on the skin of Mákke, it has stopped fluttering. A tear falls down your cheek. The strengh of the wind is not enough to take it away.

>z
Time passes.

The gale seems to calm down. There are no longer two water hells, one above and one below. The rain falls hard but you do not drown anymore. Lightning light up the sky stopped a while.

>z
Time passes.

The squall seems to be passing. It's still raining and the sea is still wild, but it's definitely tamer. You note this because the winds does not want to throw you down the cliff.

>z
Time passes.

The storm start to disipate. The clouds seem to have already unloaded all their rain and turn gray instead of black.

>z
Time passes.

It's over. The wineskin empties of the last of its wind and the clouds disperse. The sea is calm again. On the horizon you can see the black ships rising their banners and coming closer and closer.

    *** You could not call forth the storm and your village will die at the hands of the men of the black ships. ***

Would you like to RESTART, RESTORE a saved game, QUIT or UNDO the last command?

* * *

>summon
The old tongue grabs at your throat and teeth, turns the air thick around you. You keep on reciting the spell as you feel the arm holding the wineskin grow heavy.

 Suuren tuulen nostajaksi
 Sään rajun rakentajaksi
 
 Tuopa taita tammen latvat
 Rutaise rutiset raijat
 
The wind howls now, bringing grey clouds that already tell of the coming storm. The waves come in stronger and faster, smashing against the cliff in cold, white foam.

>g
The wineskin fills up, slowly at first. The folds in the leather smooth out. Far away the sky darkens. The storm is turning it black, black as the ships coming upon the horizon. Your arm hurts and shakes. Your head hurts too, a dull and pounding pain. Reciting the spell is getting harder by the moment. There's a taste of salt and iron in the air.

 Nouse tuuli tuulemahan
 Vihkurit vetelemään
 
 Nouse tuuli tuulemahan
 Ilseainta riehkimään
 
The wind roars trying to tear the wineskin off your arm. The high waves pound the cliff as if trying to bring it down. Rain pours from the angry dark clouds. The black ships buck and yaw against the gale and the rain. They've gathered sails, so that the wind does not rip them to shreds.

>g
Your own voice seems to be coming from outside yourself: a strange, shrill echo. The light is being eaten by the black clouds closing over your head. the wind is cold and gusty, whipping the waves that lap the bay's stones. The wineskin is swollen, heavy as a drowned man. You have trouble breathing: the air entering your lungs feels like thick, briny water.

 Tuule tuuli kuusi vuotta
 Seuro seitsemän kesää
 
 Itse kuoho kosken lailla
 Sekä valtona vallitse
 
Waves and rain blend together in a crazed whirl. Everything disappears under the water. Even the cliff stones shake and tumble and surrender. Lightning slashes the sky apart. The wind roars and threatens to throw you down the cliff. The fury of the elements is such that you know the black ships will soon be doomed.

>g
You wait; you wait until the storm inside your head and the storm in the sky are one, until your body is in two places at once, until the wineskin nearly flies from your grip, trying to release the fury of the winds.

 But no. Not yet. The power will flow obeying your words and your will, not the blind fury of the storm: this is your duty as a witch.

 Miestä mustoa rukoilen
 Suuren tuulen nostajaksi
 
 But the rune of Akka doesn't respond. You can't feel its energy. Something's wrong. And you know what it is: yourself, as you feared. You are no witch. You're just a foolish girl stealing power from her dead teacher. The rune cannot respond to the spell because the rune is not part of your skin. It has no witch blood to feed from.

 With your free hand you take the piece of Mákke's skin with the rune and place it upon the arm holding the wineskin. It's not the usual way; it's not the right way. But it's your call. If you really are the witch, if you are worthy of the power, what you end up doing will be what must be done. That's what Mákke said.

>g
Again you recite the final lines:

 Miestä mustoa rukoilen
 Suuren tuulen nostajaksi
 
It's not working! The rune is not part of you. It's never going to work. You scream your frustration at the storm.

>g
Again you recite the final lines:

 Miestä mustoa rukoilen
 Suuren tuulen nostajaksi
 
But it is not working. The rune is still not a part of you.

>z
Time passes.

>z
Time passes.

For an instant everything is still, as if time had stopped over the witch stone even though all around you there's a tumult of wind and water. Then the moment passes and the full force of the tempest falls on you, everything turning to wind, water and hail.

>z
Time passes.

A huge wave crashes against the rocks, sending foam all the way up to the witch stone and drenching you in cold sea water.

>z
Time passes.

>z
Time passes.

A strong wind blows over the witch stone threatening to throw both you and Mákke down the cliff. You grab the stone and your teacher's body to stop the gods from taking her away.

>z
Time passes.

The lightning has stopped looking for the black ships. One lightning strikes near the witch stone. Too close. The noise almost leaves you deaf. A warning. Perhaps all this has been nothing more than an offense to the gods and your teacher.

>z
Time passes.

The wind tries to tear away the cloak covering Mákke, but you keep it in place.

Despair growns inside you and you feel the spell's strenght waning accordingly. You look at the piece of Mákke's skin wearing the rune of Akka: it has stopped fluttering. A tear falls down your cheek. The wind is no longer strong enough to take it away.

>summon
Again you recite the final lines:

 Miestä mustoa rukoilen
 Suuren tuulen nostajaksi
 
But it is not working. The rune is still not a part of you.

The gale seems to calm down. There are no longer two fearful maelstroms, one above and one below you. The rain falls hard but does not drown you anymore. The lightning burning the sky stopped a while ago.

>summon
You have lost all your borrowed power.
 The wineskin loses energy and your words lose their capacity to alter the fabric of existence.

The squall seems to be passing. It's still raining and the sea is still wild, but it's definitely tamer. The winds do not seem to want to throw you down the cliff.

>summon
You have lost all your borrowed power.
 You raise the knife to the skies in a desperate pleading, shouting your frustration to the wind: "Mákke! What must I do? Teacher Mákke, please help me!"

As if in answer a bolt of lightning hits the cliff, shattering the rocks. The light blinds you, the deafening crack of thunder stuns you. If this is your answer, it's an irate one.

The storm start to disipate. The clouds seem to have already unloaded all their rain and turn gray instead of black.

>examine knife
Now the knife is covered in Mákke's black witch blood.

The gray sky lights up; thunder rolls in the distance.

It's over. The wineskin empties of the last of its wind and the clouds disperse. The sea is calm again. On the horizon you can see the black ships rising their banners and coming closer and closer.

    *** You could not call forth the storm and your village will die at the hands of the men of the black ships. ***

Would you like to RESTART, RESTORE a saved game, QUIT or UNDO the last command?

>undo
Cliff
[Previous turn undone.]

>examine clouds
Gray clouds swirl up in the sky. The wind is picking up, rising waves.

Above you the gray sky lights up and thunder rolls over the cliff.

It's over. The wineskin empties of the last of its wind and the clouds disperse. The sea is calm again. On the horizon you can see the black ships rising their banners and coming closer and closer.

    *** You could not call forth the storm and your village will die at the hands of the men of the black ships. ***

Would you like to RESTART, RESTORE a saved game, QUIT or UNDO the last command?

>undo
Cliff
[Previous turn undone.]

>examine clouds
Gray clouds swirl up in the sky. The wind is picking up, rising waves.

It's over. The wineskin empties of the last of its wind and the clouds disperse. The sea is calm again. On the horizon you can see the black ships rising their banners and coming closer and closer.

    *** You could not call forth the storm and your village will die at the hands of the men of the black ships. ***

Would you like to RESTART, RESTORE a saved game, QUIT or UNDO the last command?

>undo
Cliff
[Previous turn undone.]

>examine knife
Now the knife is covered in Mákke's black witch blood.

Above you the gray sky lights up and thunder rolls over the cliff.

It's over. The wineskin empties of the last of its wind and the clouds disperse. The sea is calm again. On the horizon you can see the black ships rising their banners and coming closer and closer.

    *** You could not call forth the storm and your village will die at the hands of the men of the black ships. ***

Would you like to RESTART, RESTORE a saved game, QUIT or UNDO the last command?

* * *

>summon
You don't ask permission from Árvet. You don't ask permission from Mákke. The living belong to Life. The dead belong to Death.

 Witches belong nowhere.

You uncork the wineskin and offer it up to the wind.

 Tuulen Ukko tuulen Akka
 Tuulen kaikki ristikansa
 
 Miestä mustoa rukoilen
 Suuren tuulen nostajaksi
 
The wind starts blowing, making the waves rise.

>mover arm
I didn't understand that sentence.