Me, myself and another me
Un relato interactivo por Juan Pedraza
Release 1 / Serial number 200825 / Inform 7 build 6M62 (I6/v6.33 lib 6/12N) SD

Garaje
 Despiertas en lo que parece un garaje hecho de cemento, una triste bombilla colgando del techo apenas llega a iluminar el garaje. Una mancha negra de aceite en el suelo que no disimula que hubo un coche aquí una vez. Cerca de esta, una mesa de trabajo pegada a la pared, con varias herramientas de trabajo encima de ella llenas de aceite, el aceite no te da buenas sensaciones. De uno de sus cajones gotea aceite constantemente, hay una nota algo manchada, pegada a uno de los laterales de la mesa. En una esquina un soporte con una delgada barra metálica, alcanzaba poco más que el tamaño de una persona. Al oeste ves una puerta de metal, bastante enclenque. 

Puedes ver un puerta enclenque, unos herramientas, un bombilla y una nota.

>habla con joe
[1] Who are you?
[2] Do you like a monkey?
[3] Say nothing

>1
"My name is Joe Schmoe and Inform hates me."

[1] Why does Inform hate you?
[2] I don't care.
[3] Do you like a monkey?
[4] Say nothing

>1
"I tried to compile a game and it gave me 40 Problem messages."

[1] You probably just left out a semi-colon.
[2] Ha, ha. Inform hates you.
[3] Do you like a monkey?
[4] Say nothing

>1
"Thanks so much! You're the greatest!"

    *** You have won ***

¿Quieres REINICIAR, RECUPERAR un juego guardado, TERMINAR o hacer UNDO del último comando?

>undo
Joe Schmoe's Place
[Retrocediendo al turno anterior.]

>habla con joe
[1] You probably just left out a semi-colon.
[2] Ha, ha. Inform hates you.
[3] Do you like a monkey?
[4] Say nothing

>2
"I hate you!"

 Joe kills you.

    *** You have died ***

¿Quieres REINICIAR, RECUPERAR un juego guardado, TERMINAR o hacer UNDO del último comando?

>undo
Joe Schmoe's Place
[Retrocediendo al turno anterior.]

>3
"Of course I like monkeys."

[1] What about apes?
[2] What about lemurs?

>1
"Apes are OK, I guess."

[1] You probably just left out a semi-colon.
[2] Ha, ha. Inform hates you.
[3] Only crazy people like monkeys.
[4] No, I said "a monkey", not "monkeys".
[5] I like monkeys too.
[6] Say nothing

>4
"I hate pedants!"

 Joe kills you.

    *** You have died ***

¿Quieres REINICIAR, RECUPERAR un juego guardado, TERMINAR o hacer UNDO del último comando?

>undo
Joe Schmoe's Place
[Retrocediendo al turno anterior.]

>habla con joe
[1] You probably just left out a semi-colon.
[2] Ha, ha. Inform hates you.
[3] Only crazy people like monkeys.
[4] No, I said "a monkey", not "monkeys".
[5] I like monkeys too.
[6] Say nothing

>3
"I hate you!"

 Joe kills you.

    *** You have died ***

¿Quieres REINICIAR, RECUPERAR un juego guardado, TERMINAR o hacer UNDO del último comando?

>undo
Joe Schmoe's Place
[Retrocediendo al turno anterior.]

* * *

>habla con joe
[1] You probably just left out a semi-colon.
[2] Ha, ha. Inform hates you.
[3] Only crazy people like monkeys.
[4] No, I said "a monkey", not "monkeys".
[5] I like monkeys too.
[6] Say nothing

>5
"Now we can be friends!"

    *** You have won ***

¿Quieres REINICIAR, RECUPERAR un juego guardado, TERMINAR o hacer UNDO del último comando?

>undo
Joe Schmoe's Place
[Retrocediendo al turno anterior.]

>5
"Now we can be friends!"

    *** You have won ***

¿Quieres REINICIAR, RECUPERAR un juego guardado, TERMINAR o hacer UNDO del último comando?

* * *

>undo
Joe Schmoe's Place
[Retrocediendo al turno anterior.]

>xyzzy
What's the other magic word?

[1] PLUGH
[2] There are at least two; which one?

>1
"Now we can be friends!"

    *** You have won ***

¿Quieres REINICIAR, RECUPERAR un juego guardado, TERMINAR o hacer UNDO del último comando?

>undo
Joe Schmoe's Place
[Retrocediendo al turno anterior.]

* * *

>xyzzy
What's the other magic word?

[1] PLUGH
[2] There are at least two; which one?

>2
"I hate pedants!"

 Joe kills you.

    *** You have died ***

¿Quieres REINICIAR, RECUPERAR un juego guardado, TERMINAR o hacer UNDO del último comando?

* * *

>wake beauty
Yes, but how?

>shake her
That's not a verb I recognise.

>move her
Sleeping Beauty might not like that.

>take her
I don't suppose Sleeping Beauty would care for that.

>kiss her
Sleeping Beauty slowly stirs to wakefulness!

Throughout the palace you can hear the other sounds of stirring and movement as the spell of centuries is broken.

>l
Spinning Tower
A remote corner of the old castle, reserved for spinning and weaving tasks.

Sleeping Beauty stands beside you, looking a little confused.

>talk to beauty
That's not a verb I recognise.

>i
You are carrying:
  a jug of water

>pour water on beauty
You lack the nerve when it comes to the crucial moment.

* * *

>pour water on beauty
You pour out the jug of water on Sleeping Beauty.

Sleeping Beauty wakes, shuddering. "Agh! I had a terrible dream about drowning and then-- Hey!"

Throughout the palace you can hear the other sounds of stirring and movement as the spell of centuries is broken.

>l
Spinning Tower
A remote corner of the old castle, reserved for spinning and weaving tasks.

Sleeping Beauty stands beside you, looking a little confused.

>kiss beauty
Sleeping Beauty might not like that.

>i
You are carrying nothing.

>l
Spinning Tower
A remote corner of the old castle, reserved for spinning and weaving tasks.

Sleeping Beauty stands beside you, looking a little confused.

>m
That's not a verb I recognise.

* * *

>take today
Taken.

>read it
Full of glossy illustrations of dragons in various stages of capture, captivity, and destruction. The back of the magazine contains small black-and-white advertisements for hunting kits and the like.

>drop it
Dropped.

>w
You can't go that way.

>e
You can't go that way.

>n
You can't go that way.

>s
You can't go that way.

>examine paneling
Just the sort of ornate panels that might conceal a carved switch. You've heard all sorts of rumors about secret rooms and passages in the palace, some of which have not been opened in centuries because no one remembers how to get at them.

>search paneling
You run your hands over the paneling with a methodical touch, knowing exactly what you're looking for but never quite feeling anything that gives or twists; then thump lightly, looking for hollow spaces.

>examine carpet
A dull, unwelcoming weave, only a touch redder than the wood around you. You discern that it does not lie perfectly flat.

>look under carpet
You take a corner of the carpet and tug. The floor is sticky, so it doesn't come up on the first try.

>look under carpet
Before you can act, you hear movement from the inner office. You freeze, not quite ready to be discovered in this situation. But no one comes out, and you begin to breathe more easily.

>look under carpet
You find nothing of interest.

You pull again at the carpet. There is a tug, then a tearing, as the ancient fabric struggles against the fabric glue. Some of the carpet winds up in your hand and some of it remains in patchy threads adhering to the floor.

Just at this inopportune moment, you hear a throat being cleared behind you. "We can see you now within," says a dry voice.

    *** To be continued... ***

Would you like to RESTART, RESTORE a saved game, QUIT or UNDO the last command?

>undo
Waiting Suite
[Previous turn undone.]

>examine dragon
(the copy of Dragon Pursuit Today)
Full of glossy illustrations of dragons in various stages of capture, captivity, and destruction. The back of the magazine contains small black-and-white advertisements for hunting kits and the like.

>l
Waiting Suite
You find yourself in a narrow room, more cozy than is really comfortable, with dark paneling on all the walls. Underfoot is a thick carpet the color of dried blood. The head of a dragon kit is mounted on the wall.

You can see a copy of Dragon Pursuit Today and a small table here.

>examine head
Its eyes are wide with bewildered surprise; its mouth gapes, its forked tongue protrudes indignantly. From down here it looks as though there's something shiny stuck in its mouth, though you can't tell for sure.

In the dragon head is a shiny thing.

>examine mouth
Its eyes are wide with bewildered surprise; its mouth gapes, its forked tongue protrudes indignantly. From down here it looks as though there's something shiny stuck in its mouth, though you can't tell for sure.

In the dragon head is a shiny thing.

>climb table
Little is to be achieved by that.

>l
Waiting Suite
You find yourself in a narrow room, more cozy than is really comfortable, with dark paneling on all the walls. Underfoot is a thick carpet the color of dried blood. The head of a dragon kit is mounted on the wall.

You can see a copy of Dragon Pursuit Today and a small table here.

>climb table
Little is to be achieved by that.

>take head
That's hardly portable.

>enter table
You climb onto the small table, noticing belatedly that you are leaving muddy footprints on its polished surface. Oh well: you can wipe them away again when you get down.

Just at this inopportune moment, you hear a throat being cleared behind you. "We can see you now within," says a dry voice.

    *** To be continued... ***

Would you like to RESTART, RESTORE a saved game, QUIT or UNDO the last command?

* * *

>untar raquel
¿Qué quieres untar Raquel ?

* * *

>anoint rachel
You can't see any such thing.

>anoit raquel
That's not a verb I recognise.

>anoint raquel
What do you want to anoint Raquel with?

>remove frasco
You aren't wearing the frasco.

>sacar frasco
That's not a verb I recognise.

* * *

>put frasco on table
(first taking the frasco)
You put the frasco on the table.

>take frasco
Taken.

>undo
Lugar
[Previous turn undone.]

>remove frasco
You aren't wearing the frasco.

* * *

>talk to chief
You say hello to the Chief.

You could ask about his family or ask what's up.

* * *

>talk to barmaid
You say hello to the barmaid.

>say hi
That doesn't seem to be a topic of conversation at the moment.

* * *

>denude
I didn't understand that sentence.

>disrobe
(Joe Schmoe)
You aren't wearing Joe Schmoe.

>undress
I didn't understand that sentence.

>strip
I didn't understand that sentence.

>unclothe
I didn't understand that sentence.

* * *

>joe, sesame
[Use TALK TO to interact with characters.]

>l
Joe Schmoe's Place
You are in Joe Schmoe's place.

You can see Joe Schmoe here.

* * *

>n
Hexagonal Temple
The temple walls are great ashlar blocks rising to a hundred feet overhead, perhaps more; the roof is a scarlet awning only, through which the sun filters down in blood hues. Overseeing all is a sculpture in stone and ivory. A prayer mat at the idol's feet, and an incense stick still burning on the pedestal, indicate that someone was only recently consigning her grievances to the care of the deity.

On the pedestal is an incense stick.

>n
You can't go that way.

>w
You can't go that way.

* * *

>n
You can't go that way.

>s
Sand-Floored Chamber
The constant wind has filled this chamber with a layer of fine red sand, as soft as powder snow. Something sparkling is half-buried in the corner. A doorway lies open to the north.

>s
You can't go that way.

>e
You can't go that way.

>w
You can't go that way.

>take all
(the sparkling diamond)
Taken.

>take all
There are none at all available!

>m
That's not a verb I recognise.

>s
You can't go that way.

>n
Hexagonal Temple
The temple walls are great ashlar blocks rising to a hundred feet overhead, perhaps more; the roof is a scarlet awning only, through which the sun filters down in blood hues. Overseeing all is a sculpture in stone and ivory. A prayer mat at the idol's feet, and an incense stick still burning on the pedestal, indicate that someone was only recently consigning her grievances to the care of the deity.

On the pedestal is an incense stick.

>take all
mat: Taken.
incense stick: Taken.

>l
Hexagonal Temple
The temple walls are great ashlar blocks rising to a hundred feet overhead, perhaps more; the roof is a scarlet awning only, through which the sun filters down in blood hues. Overseeing all is a sculpture in stone and ivory.

>drop all
incense stick: Dropped.
mat: Dropped.
sparkling diamond: Dropped.

* * *

>s
No puedes ir por ahí.

>e
No puedes ir por ahí.

>w
Escaleras de caracol
 Unas escaleras metalicas llenas de suciedad. No parecen ser muy seguras, cada vez que las usas se mueven ligeramente como su fueran a romperse en cualquier momento.

* * *

>i
No llevas nada.

>m
Garaje
Estas en el garaje inacabado, lleno de aceite y mal iluminado.

>m
Garaje
Estas en el garaje inacabado, lleno de aceite y mal iluminado.

>e
No puedes ir por ahí.

* * *

>w
Escaleras de caracol
 Unas escaleras metalicas llenas de suciedad. No parecen ser muy seguras, cada vez que las usas se mueven ligeramente como su fueran a romperse en cualquier momento.

>s
No puedes ir por ahí.

>n
No puedes ir por ahí.

>sube
Pasillo
 Un pasillo extremadamente decorado con maderas de caoba oscura, pareciera que pertenecise a una casa de algun rico del siglo anterior, todo limpio y lujoso. Una alfombra larga decora el suelo de madera oscura que conjunta con sus paredes. Varios cuadros colgando de la pared, amenizan el estancado color de madera de las paredes y en todos las misma silueta sombria sin rostro los protagoniza.

Puedes ver una mesita (en la cual ves un mando de la television).

>coger mando
Cogido.

* * *

>examinar nota
Esta algo arrugada y tiene palabras tachadas, pero aún es leíble;

Para mi yo,

Ya he mandado a la grúa venir a por el coche. No podía dejar que entraran en casa, así que tuve que sacar el coche fuera después de --------- de manchas de ------. Es mejor que no pregunten demasiado, les he dicho que -------- el coche contra una -------. No estoy seguro de que se lo tragasen, pero, será mejor no ----- -------, metí --- ------ en la mesa de trabajo del garaje.