The Bed
An sad song by Ruber Eaglenest and Lou Reed
Release 1 / Serial number 200928 / Inform 7 build 6M62 (I6/v6.33 lib 6/12N) SD

(In this short piece, you can only move around the mansion and look. No more actions implemented. Also, abreviatures does not work, you must type the whole directions, that is: use "north", "northeast", "east", etc.) 

(Content Warning: gender violence, drug abuse, prostitution and other problematic topics.)

Entrance
The mansion stands before me, along with my memories and regrets.

From here I can go to the north.

>s
My regrets say it is too soon to leave. There's more painful memories to retell.

>s
You can't go that way.

>s
You can't go that way.

* * *

>s
My regrets say it is too soon to leave. There's more painful memories to retell.

>n
The marble hall
This is the place where we used to live 
I paid for it with love and blood

>s
I never would have started if I'd known
 that it'd end this way
 But funny thing, I'm not at all sad
 that it stopped this way
 stopped this way

    *** The End ***

Would you like to RESTART, RESTORE a saved game, QUIT or UNDO the last command?

* * *

The Bed
An sad song by Ruber Eaglenest and Lou Reed
Release 1 / Serial number 200928 / Inform 7 build 6M62 (I6/v6.33 lib 6/12N) SD

(In this short piece, you can only move around the mansion and look. No more actions implemented. Also, abreviatures does not work, you must type the whole directions, that is: use "north", "northeast", "east", etc.) 

(Content Warning: gender violence, drug abuse, prostitution and other problematic topics.)

Entrance
The mansion stands before me, along with my memories and regrets.

From here I can go to the north.

>l
The main hall
This is the place where I waited for my rich father to die
 I tried to handle things the best way I can

>e
You can't go that way.

>e
You can't go that way.

* * *

The Bed
An sad song by Ruber Eaglenest and Lou Reed
Release 1 / Serial number 200928 / Inform 7 build 6M62 (I6/v6.33 lib 6/12N) SD

(In this short piece, you can only move around the mansion and look. No more actions implemented. Also, abreviatures does not work, you must type the whole directions, that is: use "north", "northeast", "east", etc.) 

(Content Warning: gender violence, drug abuse, prostitution and other problematic topics.)

Entrance
The mansion stands before me, along with my memories and regrets.

From here I can go to the north.

>n
(In this piece, you must not use abreviatures for movement. Type the whole word, like "north" or "go to the southeast", etc.)

>w
Stables
This is the place where our horses were taken cared for
 They only left some fodder and dung

>e
The main hall
This is the place where I waited for my rich father to die
 At heart I tried to act like a man
 I tried to handle things the best way I can

>e
Servant's corridor

>e
That is the place where the servants

I beg your pardon?

>n
Kitchen
This is the place were our family was feed
 They only left some crumbs and stuff

>w
Pantry

>a
That's not a verb I recognise.

>sw
The main hall
 My castle, kids and home
 I thought she was Mary, Queen of Scots
 I tried so very hard

>up
Stairs landing
This is the place where she descended in her ball dress
 She seemed very regal to me
 just goes to show how wrong you can be

>up
Upper hall
This is the place where she said I'm not a man
 so she'll go get it catch as catch can

>w
West gallery

>w
You can't go that way.

>s
Children's bedroom
And this is the place where our children played
 Those bright and hopeful days

>w
The children's bath room
They took our children away
 Because they said she was not a good mother

>e
Children's bedroom
 And this is the place where they took our children away
 That tragic and fateful day
 And I said, oh, oh, oh, oh, oh, oh, what a feeling

>e
You can't go that way.

>n
West gallery
This is the place where I just stood there
 a tired man, no words to say

>n
The study
This is the place where I hid from her
 from the children, the world and stuff

>s
West gallery

>e
Upper hall
 The things she did, the things she said
 people shouldn't treat others that way
 But at first I thought I could take it all

>e
East gallery

>n
Living room
This is the place where we took absentia and opium
 and I asked her what is in her mind

>s
East gallery

>s
Library
And these are the books that she kept on the shelf
 Filled with her poetry and stuff

>n
East gallery

>e
The bed
This is the place where she lay her head when she went to bed at night

>e
You can't go that way.

>s
You can't go that way.

>n
Bath room
And this is the place where she cut her wrists
 that odd and fateful night
 And I said, oh, oh, oh, oh, oh, oh, what a feeling

>s
The bed
And this is the place our children were conceived candles lit the room brightly at night

>w
East gallery

>w
Upper hall

>d
Stairs landing
This is the place where she stand proud and with disdain at me
 lookin" through the eyes of hate

>d
The main hall

>s
I never would have started if I'd known that it'd end this way But funny thing, I'm not at all sad that it stopped this way

    *** The End ***

Would you like to RESTART, RESTORE a saved game, QUIT or UNDO the last command?

* * *

>n
(In this piece, you must not use abreviatures for movement. Type the whole word, like "north" or "go to the southeast", etc.)

>s
My regrets say it is too soon to leave. There's more painful memories to retell.

>undo
Entrance
[Previous turn undone.]

>take
That's not a verb I recognise.

>n
In this piece, you must not use aberviatures for movement. Type the whole word, like "north" or "go to the southeast".

>n
In this piece, you must not use aberviatures for movement. Type the whole word, like "north" or "go to the southeast".

>s
My regrets say it is too soon to leave. There's more painful memories to retell.

>n
In this piece, you must not use aberviatures for movement. Type the whole word, like "north" or "go to the southeast".

>north
The marble hall
This is the place where we used to live 
I paid for it with love and blood 

From here I can go to the south, the west, the northwest, the northeast, the east and the up.

* * *

>n
(In this piece, you must not use abreviatures for movement. Type the whole word, like "north" or "go to the southeast", etc.)

>north
The marble hall
This is the place where we used to live 
I paid for it with love and blood 

From here I can go to the south, the west, the northwest, the northeast, the east and the up.

>east
Servant's corridor
This is the place where the servants toiled away 
There are none of them left now 

From here I can go to the west, the north and the east.

>west
The marble hall
My castle, kids and home 
I thought she was Mary, Queen of Scots
 I tried so very hard

From here I can go to the south, the west, the northwest, the northeast, the east and the up.

>south
I never would have started if I'd known
 that it'd end this way
 But funny thing, I'm not at all sad
 that it stopped this way
 stopped this way

    *** The End ***

Would you like to RESTART, RESTORE a saved game, QUIT or UNDO the last command?

>restart
The Bed
An sad song by Ruber Eaglenest and Lou Reed
Release 1 / Serial number 200726 / Inform 7 build 6M62 (I6/v6.33 lib 6/12N) SD

(In this short piece, you can only move around the mansion and look. No more actions implemented. Also, abreviatures does not work, you must type the whole directions, that is: use "north", "northeast", "east", etc.) 

(Content Warning: gender violence, drug abuse, prostitution and other problematic topics.)

Entrance
The mansion stands before me, along with my memories and regrets.

From here I can go to the north.

>version
The Bed
An sad song by Ruber Eaglenest and Lou Reed
Release 1 / Serial number 200726 / Inform 7 build 6M62 (I6/v6.33 lib 6/12N) SD

(In this short piece, you can only move around the mansion and look. No more actions implemented. Also, abreviatures does not work, you must type the whole directions, that is: use "north", "northeast", "east", etc.) 

(Content Warning: gender violence, drug abuse, prostitution and other problematic topics.)

Identification number: //6CA25311-0B73-4C34-9B95-CA31A67C5483//
Interpreter version 0.5.4 / VM 3.1.2 / Library serial number 080126
Standard Rules version 3/120430 by Graham Nelson

>credits
That's not a verb I recognise.

* * *

>n
(In this piece, you must not use abreviatures for movement. Type the whole word, like "north" or "go to the southeast", etc.)

>n
(Use whole words for movement: "north", "south", "southwest", etc.)

>n
(That's not an action I recognise.)

>take house
That's not a verb I recognise.

>n
(That's not an action I recognise.)

>north
The marble hall
This is the place where we used to live 
I paid for it with love and blood 

From here I can go to the south, the west, the northwest, the northeast, the east and the up.

* * *

The Bed
An sad song by Ruber Eaglenest and Lou Reed
Release 1 / Serial number 200928 / Inform 7 build 6M62 (I6/v6.33 lib 6/12N) SD

(In this short piece, you can only move around the mansion and look. No more actions implemented. Also, abreviatures does not work, you must type the whole directions, that is: use "north", "northeast", "east", etc.) 

(Content Warning: gender violence, drug abuse, prostitution and other problematic topics.)

Entrance
The mansion stands before me, along with my memories and regrets.

From here I can go to the north.

>resaltado
The Bed usa un sistema de palabras resaltadas. Es recomendable que su intérprete pueda mostrar correctamente estos resaltados. Escriba un número de los inferiores hasta encontrar una forma de resaltado que se vea claramente en su intérprete.

1) Un object resaltado se verá así.
2) Una salida resaltada se verá así.
3) Un lugar resaltado se verá así.

**Aviso: Frecuentemente será útil poder distinguir entre diversas clases de resaltado.**

Teclee 0 si ha finalizado, o 9 para activar el modo lector.

>9
El modo "lector" ha sido activado. The Bed usará letras en las palabras resaltadas para indicar aquellas que sean importantes y que podrá teclear para avanzar en este relato. Su intérprete incluirá resaltados como este. Puede teclear cosas para ver cosas relevantes que estén por las cercanías, o salidas para ver las salidas cercanas. Teclee claves para ajustar las opciones de resaltado de las palabras, o teclee "lector" para encender y apagar esta clase de resaltado.

Pulse cualquier tecla para continuar.

* * *

>m
(Eso no es un verbo que entienda ni una clave que se pueda usar en este momento.)

>l
pantry
(Eso no es un verbo que entienda ni una clave que se pueda usar en este momento.)

>x
What do you want to examine?

* * *

The Bed
An sad song by Ruber Eaglenest and Lou Reed
Release 1 / Serial number 200928 / Inform 7 build 6M62 (I6/v6.33 lib 6/12N) SD

(In this short piece, you can only move around the mansion and look. No more actions implemented. Also, abreviatures does not work, you must type the whole directions, that is: use "north", "northeast", "east", etc.) 

(Content Warning: gender violence, drug abuse, prostitution and other problematic topics.)

Entrance
The mansion stands before me, along with my memories and regrets.

From here I can go to the north.

>main hall
(Eso no es un verbo que entienda ni una clave que se pueda usar en este momento.)

>main
(Eso no es un verbo que entienda ni una clave que se pueda usar en este momento.)

>take hall
You can't see any such thing.

* * *

The Bed
An sad song by Ruber Eaglenest and Lou Reed
Release 1 / Serial number 200928 / Inform 7 build 6M62 (I6/v6.33 lib 6/12N) SD

(In this short piece, you can only move around the mansion and look. No more actions implemented. Also, abreviatures does not work, you must type the whole directions, that is: use "north", "northeast", "east", etc.) 

(Content Warning: gender violence, drug abuse, prostitution and other problematic topics.)

Entrance
The mansion stands before me, along with my memories and regrets.

From here I can go to the north.

>up
east
Children's Bedroom
 And this is the place where they took our children away
 That tragic and fateful day
 And I said, oh, oh, oh, oh, oh, oh, what a feeling 

Salidas: north hacia the the starlight gallery y west hacia the the children's bath room.

* * *

The Bed
An sad song by Ruber Eaglenest and Lou Reed
Release 1 / Serial number 200928 / Inform 7 build 6M62 (I6/v6.33 lib 6/12N) SD

(In this short piece, you can only move around the mansion and look. No more actions implemented. Also, abreviatures does not work, you must type the whole directions, that is: use "north", "northeast", "east", etc.) 

(Content Warning: gender violence, drug abuse, prostitution and other problematic topics.)

Entrance
The mansion stands before me, along with my memories and regrets.

From here I can go to the north.

>w
The Marble Hall
My castle, kids and home 
I thought she was Mary, Queen of Scots
 I tried so very hard

From here you can go south to entrance, west to stables, northwest to crystal corridor, northeast to pantry, east to servant's corridor and up to stairs landing.

>up
Stairs Landing
This is the place where she descended in her ball dress
 She seemed very regal to me
 just goes to show how wrong you can be 

From here you can go down to the marble hall and up to upper hall.

>up
Upper Hall
This is the place where she said I'm not a man
 so she'll go get it catch as catch can

From here you can go down to stairs landing, south to the parlor, west to the the twilight gallery and east to the the dawnlight gallery.

>e
The Dawnlight Gallery
This is the place where I waited for my rich father to die 
At heart I tried to handle things the best way I can 

From here you can go west to upper hall, east to the the bed, south to the the study and north to living room.

>n
Living Room
This is the place where we took absentia and opium
 and I asked her what is in her mind 

From here you can go south to the the dawnlight gallery.

>s
The Dawnlight Gallery

From here you can go west to upper hall, east to the the bed, south to the the study and north to living room.

>s
The Study
This is the place where I hid away from her 
from the children, the world and stuff

From here you can go north to the the dawnlight gallery.

* * *

The Bed
An sad song by Ruber Eaglenest and Lou Reed
Release 1 / Serial number 200928 / Inform 7 build 6M62 (I6/v6.33 lib 6/12N) SD

(In this short piece, you can only move around the mansion and look. No more actions implemented. Also, abreviatures does not work, you must type the whole directions, that is: use "north", "northeast", "east", etc.) 

(Content Warning: gender violence, drug abuse, prostitution and other problematic topics.)

Entrance
The mansion stands before me, along with my memories and regrets.

From here I can go to the north.

>take
What do you want to take?

>n
You must name something more substantial.

>n
The marble hall
This is the place where we used to live 
I paid for it with love and blood 

From here I can go to the south, the west, the northwest, the northeast, the east and the up.

>up
Stairs landing
This is the place where she descended in her ball dress
 She seemed very regal to me
 just goes to show how wrong you can be 

From here I can go to the down and the up.

>take stair
You can't see any such thing.

>up
Upper hall
This is the place where she said I'm not a man
 so she'll go get it catch as catch can

From here I can go to the down, the south, the west and the east.

>w
The twilight gallery

From here I can go to the east, the north and the south.

>s
Children's bedroom
And this is the place where our children played
 Those bright and hopeful days

From here I can go to the north and the west.

>take bed
You can't see any such thing.

>n
The twilight gallery
This is the place where I just stood there 
a tired man, no words to say 

From here I can go to the east, the north and the south.

>e
Upper hall
 The things she did, the things she said
 people shouldn't treat others that way
 But at first I thought I could take it all

From here I can go to the down, the south, the west and the east.

>take
What do you want to take?

>sing
You can't see any such thing.

>i
You can only move around using the full cardinal directions. No abbreviatures allowed either.

>take the bed
You can't see any such thing.

* * *

The Bed
An sad song by Ruber Eaglenest and Lou Reed
Release 1 / Serial number 200928 / Inform 7 build 6M62 (I6/v6.33 lib 6/12N) SD

(In this short piece, you can only move around the mansion and look. No more actions implemented. Also, abreviatures does not work, you must type the whole directions, that is: use "north", "northeast", "east", etc.) 

(Content Warning: gender violence, drug abuse, prostitution and other problematic topics.)

Entrance
The mansion stands before me, along with my memories and regrets.

From here I can go to the north.

>e
(In this piece, you must not use aberviatures for movement. Type the whole word, like "north" or "go to the southeast".)

>n
In this piece, you must not use aberviatures for movement. Type the whole word, like "north" or "go to the southeast".

* * *

>e
(In this piece, you must not use aberviatures for movement. Type the whole word, like "north" or "go to the southeast".)

>w
(In this piece, you must not use aberviatures for movement. Type the whole word, like "north" or "go to the southeast".)

>north
The marble hall
This is the place where we used to live 
I paid for it with love and blood 

From here I can go to the south, the west, the northwest, the northeast, the east and the up.

* * *

The Bed
An sad song by Ruber Eaglenest and Lou Reed
Release 1 / Serial number 200928 / Inform 7 build 6M62 (I6/v6.33 lib 6/12N) SD

(In this short piece, you can only move around the mansion and look. No more actions implemented. Also, abreviatures does not work, you must type the whole directions, that is: use "north", "northeast", "east", etc.) 

(Content Warning: gender violence, drug abuse, prostitution and other problematic topics.)

Entrance
The mansion stands before me, along with my memories and regrets.

From here I can go to the north.

>i
That's not a verb I recognise.

>take
That's not a verb I recognise.