Prisionero de la tormenta
Una huida desesperada por Ruber Eaglenest
Release 1 / Serial number 211211 / Inform 7 build 6M62 (I6/v6.33 lib 6/12N) SD

Huyendo por las alcantarillas
Las paredes se juntan con el techo abovedado. Rezuman limo, musgo y hongos. El fango ora te llega por los tobillos ora por las rodillas y todo huele de forma terriblemente espantosa. Y la penumbra no es tan densa como para evitarte ver todos los detalles desagradables. Hacia atrás está la vuelta a los pantanos y con ellos los trabajos forzados y la prisión. No los ves allá atrás, pero los policías con sus perros rastreadores no deben de andar muy lejos. Hacia adelante el túnel continúa y continúa.

Como un espectro encadenado
crucé el mercado, huyendo del sol.
Oí que labios desalmados
pusieron precio a tu corazón. --

-- Tormenta de Arena, Radio Futura

>examinar pájaro
-¡Craaaak¡ -El pájaro bate las alas en un esfuerzo desesperado. Grazna un último quejido final y deja de moverse, muerto.

>examinar pájaro
-¡Craaaak¡ -El pájaro bate las alas en un esfuerzo desesperado. Grazna un último quejido final y deja de moverse, muerto.

* * *

>examinar pajaro
-¡Craaaak¡ -El pájaro bate las alas en un esfuerzo desesperado. Grazna un último quejido final y deja de moverse, muerto.

>examinar pajaro
No se mueve.

>m
Huyendo por las alcantarillas
Las paredes se juntan con el techo abovedado. Rezuman limo, musgo y hongos. El fango ora te llega por los tobillos ora por las rodillas y todo huele de forma terriblemente espantosa. Hacia atrás está la vuelta a la prisión,. No los ves, pero los policías con sus perros rastreadores no deben de andar muy lejos. Hacia adelante el túnel continúa y continúa.

Hay un pájaro muerto en el fango.

>coger pajaro
No se mueve.

* * *

>i
No llevas nada.

>examinar pajaro
-¡Craaaak¡ -El pájaro bate las alas en un esfuerzo desesperado. Grazna un último quejido final y deja de moverse, muerto.

>coger pajaro
No se mueve.

>m
Huyendo por las alcantarillas
Las paredes se juntan con el techo abovedado. Rezuman limo, musgo y hongos. El fango ora te llega por los tobillos ora por las rodillas y todo huele de forma terriblemente espantosa. Hacia atrás está la vuelta a la prisión,. No los ves, pero los policías con sus perros rastreadores no deben de andar muy lejos. Hacia adelante el túnel continúa y continúa.

Hay un pájaro muerto en el fango.

>e
No puedes ir por ahí.

>s
No puedes ir por ahí.

>n
No puedes ir por ahí.

>o
No puedes ir por ahí.

>ve hacia adelante
No conozco ese verbo.

>camina hacia adelante
No conozco ese verbo.

>corre hacia adelante
No conozco ese verbo.

>huye hacia adelante
No conozco ese verbo.

>e
No puedes ir por ahí.

* * *

>n
No sé en qué dirección está el norte, el sur, o el oeste, sólo puedes ir hacia adelante o volver atrás.

>ir hacia el norte
No sé en qué dirección está el norte, el sur, o el oeste, sólo puedes ir hacia adelante o volver atrás.

>ir hacia adelante
No conozco ese verbo.

* * *

>ir hacia el norte
No sabes en qué dirección está el norte, el sur, o el oeste, sólo puedes ir hacia adelante o volver atrás.

* * *

>avanzar
En mitad del túnel
La oscuridad es menor aquí ya que una chimenea en el techo asciende hasta una rejilla ahogada por la arena que deja pasar algo de luz. El túnel continúa y continúa durante decenas de metros, sin ningún cambio de dirección, inmutable. Aunque a lo lejos se divisa el final.

-¡Crak, craaak!- un pájaro con las alas heridas agoniza en el fango.

>retroceder
No hay vuelta atrás.

>ir hacia adelante
No ves manera de avanzar.

>ir hacia atrás
No hay vuelta atrás.

* * *

>avanzar
En mitad del túnel
La oscuridad es menor aquí ya que una chimenea en el techo asciende hasta una rejilla ahogada por la arena que deja pasar algo de luz. El túnel continúa y continúa durante decenas de metros, sin ningún cambio de dirección, inmutable. Aunque a lo lejos se divisa el final.

-¡Crak, craaak!- un pájaro con las alas heridas agoniza en el fango.

>examinar pájaro
-¡Craaaak¡ -El pájaro bate las alas en un esfuerzo desesperado. Grazna un último quejido y deja de moverse, muerto.

>examinar pájaro
-¡Craaaak¡ -El pájaro bate las alas en un esfuerzo desesperado. Grazna un último quejido y deja de moverse, muerto.

>coger pajaro
-¡Craaaak¡ -El pájaro bate las alas en un esfuerzo desesperado. Grazna un último quejido y deja de moverse, muerto.

>coger pajaro
-¡Craaaak¡ -El pájaro bate las alas en un esfuerzo desesperado. Grazna un último quejido y deja de moverse, muerto.

* * *

>avanzar
En mitad del túnel
La oscuridad es menor aquí ya que una chimenea en el techo asciende hasta una rejilla ahogada por la arena que deja pasar algo de luz. El túnel continúa y continúa durante decenas de metros, sin ningún cambio de dirección, inmutable. Aunque a lo lejos se divisa el final.

-¡Crak, craaak!- un pájaro con las alas heridas agoniza en el fango.

>avanzar
Final de las alcantarillas
El túnel termina aquí, en una sección cuadrada de la cual asciende una escalerilla metálica hacia la superficie.

En un receso de la pared hay sentado un ser andrajoso. Un hombre, o un despojo como tal. Quemado por el sol, sucio pero de gesto constantemente feliz de ojos vidriosos rodeados de una maraña de pelo y barba de semanas, o meses.

>sube
Salida de las alcantarillas
Trepas como una exhalación las escalerillas metálicas hasta llegar a lo más alto. Aquí el ambiente cambia. La tapa de la alcantarilla irradia un calor abrasador que mantiene la humedad alejada.

Un rayo de luz cae verticalmente a través de un agujero en la tapa, calentando el aire a su paso.

>sube
Empujé la pesada alcantarilla a un lado y rasgué el velo de la oscuridad. El sol literalmente quemaba la piel. Usando la tapa a modo de visera me refugié en la sombra y otee la plaza del mercado. Desierto. No había señales de la policía. Si corría lo suficiente, podría llegar a los portalillos sin llegar a tostarme mucho.

Plaza del mercado
Calor, mucho calor.

>acciones
Actions listing on.

>sube
[subiendo]
[(1) going arriba]
No sabes en qué dirección está el norte, el sur, o el oeste, sólo puedes ir hacia adelante o volver atrás.
[(1) going arriba - failed]

[subiendo - succeeded]

>ir al norte
[going norte]
No sabes en qué dirección está el norte, el sur, o el oeste, sólo puedes ir hacia adelante o volver atrás.
[going norte - failed]

>abre la tapa
[opening Tapa metálica]
[opening Tapa metálica - failed]

Empujé la pesada alcantarilla a un lado y rasgué el velo de la oscuridad. El sol literalmente quemaba la piel. Usando la tapa a modo de visera me refugié en la sombra y otee la plaza del mercado. Desierto. No había señales de la policía. Si corría lo suficiente, podría llegar a los portalillos sin llegar a tostarme mucho.

[looking]
Plaza del mercado
Calor, mucho calor.

[looking - succeeded]

* * *

>sube
Empujé la pesada alcantarilla a un lado y rasgué el velo de la oscuridad. El sol literalmente quemaba la piel. Usando la tapa a modo de visera me refugié en la sombra y otee la plaza del mercado. Desierto. No había señales de la policía. Si corría lo suficiente, podría llegar a los portalillos sin llegar a tostarme mucho.

Plaza del mercado
Calor, mucho calor.

>arriba
No puedes ir por ahí.

* * *

>avanzar
Final de las alcantarillas
El túnel termina aquí, en una sección cuadrada de la cual asciende una escalerilla metálica hacia la superficie.

En un receso de la pared hay sentado un ser andrajoso. Un hombre, o un despojo como tal. Quemado por el sol, sucio pero de gesto constantemente feliz de ojos vidriosos rodeados de una maraña de pelo y barba de semanas, o meses.

>examinar paredes
¿Cuál concretamente, el limo o el paredes?

>limo
Una sustancia verde gelatinosa que supura a través de las paredes, gotea acumulándose en el suelo en charcos informes de los cuales brotan hongos de diverso tamaño.

>examinar limo
Una sustancia verde gelatinosa que supura a través de las paredes, gotea acumulándose en el suelo en charcos informes de los cuales brotan hongos de diverso tamaño.

>cogerlo
No creo que a Maddock le gustara.

>n
No sabes en qué dirección está el norte, el sur, o el oeste, sólo puedes ir hacia adelante o volver atrás.

>atras
No hay vuelta atrás.

* * *

>avanzar
Final de las alcantarillas
El túnel termina aquí, en una sección cuadrada de la cual asciende una escalerilla metálica hacia la superficie.

En un receso de la pared hay sentado un ser andrajoso. Un hombre, o un despojo como tal. Quemado por el sol, sucio pero de gesto constantemente feliz de ojos vidriosos rodeados de una maraña de pelo y barba de semanas, o meses.

>subir
Salida de las alcantarillas
Trepas como una exhalación las escalerillas metálicas hasta llegar a lo más alto. Aquí el ambiente cambia. La tapa de la alcantarilla irradia un calor abrasador que mantiene la humedad alejada.

Un rayo de luz cae verticalmente a través de un agujero en la tapa, calentando el aire a su paso.

>subir
Empujé la pesada alcantarilla a un lado y rasgué el velo de la oscuridad. El sol literalmente quemaba la piel. Usando la tapa a modo de visera me refugié en la sombra y otee la plaza del mercado. Desierto. No había señales de la policía. Si corría lo suficiente, podría llegar a los portalillos sin llegar a tostarme mucho.

Plaza del mercado
Calor, mucho calor.

* * *

>avanzar
Final de las alcantarillas
El túnel termina aquí, en una sección cuadrada de la cual asciende una escalerilla metálica hacia la superficie.

En un receso de la pared hay sentado un ser andrajoso. Un hombre, o un despojo como tal. Quemado por el sol, sucio pero de gesto constantemente feliz de ojos vidriosos rodeados de una maraña de pelo y barba de semanas, o meses.

>examinar hombre
Es Maddock,  un viejo conocido. Un ser ruin que empeora a cada año que pasa. Pantalones vaqueros tan raídos que ahora son cortos. Camisa amarillenta de vieja y por la suciedad, y tirantes. Y encima de todo ello unos ojos vidriosos en permanente alegría, rodeados de una cara curtida por el sol llena de picaduras, viruelas y ampollas; al igual que el resto de su piel. Tiene una profusa mata de pelo y barba completamente enmarañadas. Además ha montado un pequeño campamento a su alrededor. Te mira de forma divertida.

>pregunta a maddock por hombre
No conozco ese verbo.

>pregunta qué haces aquí abajo
( a Maddock)
You can't think of anything appropriate to say. 

You could ask qué haces aquí abajo, whether qué haces aquí abajo, whether tengo que seguir, whether tengo que encontrar a Isabelita or whether en el burdel.

>qué haces aquí abajo
What would you like to discuss: qué haces aquí abajo or whether qué haces aquí abajo?

>arriba
Intenta de nuevo, porque sólo te pude entender: (IR) ir hacia algún lado.

>ve hacia arriba
Salida de las alcantarillas
Trepas como una exhalación las escalerillas metálicas hasta llegar a lo más alto. Aquí el ambiente cambia. La tapa de la alcantarilla irradia un calor abrasador que mantiene la humedad alejada.

Un rayo de luz cae verticalmente a través de un agujero en la tapa, calentando el aire a su paso.

>arriba
Empujé la pesada alcantarilla a un lado y rasgué el velo de la oscuridad. El sol literalmente quemaba la piel. Usando la tapa a modo de visera me refugié en la sombra y otee la plaza del mercado. Desierto. No había señales de la policía. Si corría lo suficiente, podría llegar a los portalillos sin llegar a tostarme mucho.

Plaza del mercado
Calor, mucho calor.

>baja
No puedes ir por ahí.

* * *

>pregunta a maddock por hombre
No conozco ese verbo.

>pregunta
¿Qué quieres preguntar?

>pregunta sobre hombre
No entendí esa frase.

>pregunta hombre
No entendí esa frase.

>acciones
Actions listing on.

>pregunta hombre
[non-speaking qué haces aquí abajo]
No entendí esa frase.
[non-speaking qué haces aquí abajo - ended without result]

>pregunta a maddock
No conozco ese verbo.

>preguntar a maddock
You're not hablando con nadie en estos momentos.

¿Perdón?

>habla con maddock
No conozco ese verbo.

>hablar con maddock
( a Maddock)
[telling Maddock about "con maddock"]
[(1) saying hello to Maddock]
[(1) saying hello to Maddock - succeeded]

You can't think en nada apropiado que decir. 

[telling Maddock about "con maddock" - failed the catch fall-throughs of telling rule]

You could pregunta qué haces aquí abajo.

* * *

>examinar hombre
Es Maddock,  un viejo conocido. Un ser ruin que empeora a cada año que pasa. Pantalones vaqueros tan raídos que ahora son cortos. Camisa amarillenta de vieja y por la suciedad, y tirantes. Y encima de todo ello unos ojos vidriosos en permanente alegría, rodeados de una cara curtida por el sol llena de picaduras, viruelas y ampollas; al igual que el resto de su piel. Tiene una profusa mata de pelo y barba completamente enmarañadas. Además ha montado un pequeño campamento a su alrededor. Te mira de forma divertida.

>decir hola
( a Maddock)
No hay respuesta.

You could ask qué haces aquí abajo.

>pregunta que haces aquí abajo
( a Maddock)
You can't think of anything appropriate to say. 

You could ask qué haces aquí abajo.

>qué haces aqui abajo
Intenta de nuevo, porque sólo te pude entender: do something to  qué haces aquí abajo.

>pregunta abajo
( a Maddock)
You can't think of anything appropriate to say. 

You could ask qué haces aquí abajo.

>pregunta sobre maddock
( Maddock)
You can't think of anything appropriate to say. 

You could ask qué haces aquí abajo.

>ask que haces aqui abajo
That doesn't seem to be a topic of conversation at the moment.

>ask
-¡Maddock! ¿Qué haces aquí abajo? - preguntas sorprendido al ver un viejo conocido en este sitio.

-¿Qué voy a hacer? Estar fresquito hombre. Ahí arriba hace 45 grados a la sombra, y en la plaza el sol achicharra a los incautos. ¿Has visto alguna vez ejecutar a alguno en la picota? Se churrascan como pollos asados, jee, jee.- rie el miserable dejando escapar el aire por su boca desdentada. -Además, aquí hay comida, ¿ves?- Añade mientras sacude delante de si una rata muerta empalada en un gancho.

You could ask tengo que seguir.

>decir tengo que seguir
( a Maddock)
No hay respuesta.

You could ask tengo que seguir.

>pregunta tengo que seguir
( a Maddock)
You can't think of anything appropriate to say. 

You could ask tengo que seguir.

>ask tengo que seguir
-Tengo que seguir. - dices mirando atrás preocupado.

-¿Vas a salir ahí arriba en pleno mediodía? ¿Es que no me has oído? ¡Ahí arriba se está a más de 50 grados a pleno sol! - advierte.

You could ask tengo que encontrar a Isabelita.

>ask tengo que encontrar a isabelita
-Tengo que encontrar a Isabelita. ¿Sabes dónde está?- preguntas.

-Sí hombre, no tiene pérdida, la encontrarás en "La luna ardiente"...- responde y parece divertirse aún más.

You could ask en el burdel.

>ask en el burdel
-¡En el burdel! -Ttomas a ese miserable por las raidas solapas.

You could ask te voy a matar.

>queue maddock
No conversation is planned for Maddock.

* * *

>avanzar
Final de las alcantarillas
El túnel termina aquí, en una sección cuadrada de la cual asciende una escalerilla metálica hacia la superficie.

En un receso de la pared hay sentado un ser andrajoso. Un hombre, o un despojo como tal. Quemado por el sol, sucio pero de gesto constantemente feliz de ojos vidriosos rodeados de una maraña de pelo y barba de semanas, o meses.

>pregunta a hombre qué hace aquí
You aren't talking to anyone.

>examinar hombre
Es Maddock,  un viejo conocido. Un ser ruin que empeora a cada año que pasa. Pantalones vaqueros tan raídos que ahora son cortos. Camisa amarillenta de vieja y por la suciedad, y tirantes. Y encima de todo ello unos ojos vidriosos en permanente alegría, rodeados de una cara curtida por el sol llena de picaduras, viruelas y ampollas; al igual que el resto de su piel. Tiene una profusa mata de pelo y barba completamente enmarañadas. Además ha montado un pequeño campamento a su alrededor. Te mira de forma divertida.

>pregunta a hombre qué hace aquí
You aren't talking to anyone.

>pregunta a maddock qué hace aquí
You aren't talking to anyone.

>pregunta a maddock qué hace aquí abajo
You aren't talking to anyone.

>decir hola
( a Maddock)
No hay respuesta.

You could ask qué haces aquí abajo.

>pregunta qué haces aquí abajo
( a Maddock)
You can't think of anything appropriate to say. 

You could ask qué haces aquí abajo.

* * *

>avanzar
Final de las alcantarillas
El túnel termina aquí, en una sección cuadrada de la cual asciende una escalerilla metálica hacia la superficie.

En un receso de la pared hay sentado un ser andrajoso. Un hombre, o un despojo como tal. Quemado por el sol, sucio pero de gesto constantemente feliz de ojos vidriosos rodeados de una maraña de pelo y barba de semanas, o meses.

>pregunta a maddock por isabelita
No conozco ese verbo.

>pregunta
¿Qué quieres preguntar?

>algo
No conozco ese verbo.

>decir hola
No conozco ese verbo.

>di hola
No conozco ese verbo.

>di
¿Qué quieres decir?

* * *

>m
Huyendo por las alcantarillas
Las paredes se juntan con el techo abovedado. Rezuman limo, musgo y hongos. El fango ora te llega por los tobillos ora por las rodillas y todo huele de forma terriblemente espantosa. Y la penumbra no es tan densa como para evitarte ver todos los detalles desagradables. Hacia atrás está la vuelta a los pantanos y con ellos los trabajos forzados y la prisión. No los ves allá atrás, pero los policías con sus perros rastreadores no deben de andar muy lejos. Hacia adelante el túnel continúa y continúa.

>adelante
En mitad del túnel
La penumbra es menor aquí. Una rejilla anegada por la arena al final de una chimenea en el techo, que deja pasar algo de luz. El túnel continúa y continúa durante decenas de metros, sin ningún cambio de dirección, húmedo y apestoso, inmutable. Aunque a lo lejos se divisa el final.

-¡Crak, craaak!- un pájaro con las alas heridas agoniza en el fango.

>examinar pájaro
No sabes si es un cuervo de alas negras, o es que está cubierto completamente de lodo.

>examinar pájaro
No sabes si es un cuervo de alas negras, o es que está cubierto completamente de lodo.

>z
El tiempo pasa...

>z
El tiempo pasa...

¿Perdón?

>z
El tiempo pasa...

>coger pajaro
-¡Craaaak! -El pájaro bate las alas en un esfuerzo desesperado. Grazna un último quejido y deja de moverse.

>m
En mitad del túnel
La penumbra es menor aquí. Una rejilla anegada por la arena al final de una chimenea en el techo, que deja pasar algo de luz. El túnel continúa y continúa durante decenas de metros, sin ningún cambio de dirección, húmedo y apestoso, inmutable. Aunque a lo lejos se divisa el final.

Hay un pájaro muerto en el fango.

>examinar pajaro
No se mueve.

>coger pajaro
Es sólo un pájaro muerto en el fango.

>adelante
Final de las alcantarillas
El túnel termina aquí, en una sección cuadrada de la cual asciende una escalerilla metálica hacia la superficie.

En un receso de la pared hay sentado un ser andrajoso. Un hombre, o un despojo. Quemado por el sol, sucio pero de gesto constantemente feliz de ojos vidriosos rodeados de una maraña de pelo y barba de semanas, o meses.

>examinar hombre
Es Maddock,  un viejo conocido. Un ser ruin que empeora a cada año que pasa. Pantalones vaqueros tan raídos que ahora son cortos. Camisa amarillenta de vieja y por la suciedad, y tirantes. Una cara curtida por el sol llena de picaduras, viruelas y ampollas; al igual que el resto de su piel. Y encima de todo ello unos ojos vidriosos en permanente alegría, Tiene una profusa mata de pelo y barba completamente enmarañadas. Además ha montado un pequeño campamento a su alrededor. Te mira de forma divertida.

>habla con hombre
[1] "¿Qué haces aquí abajo?"
[2] Decir nada.

>1
-¡Maddock! ¿Qué haces aquí abajo? - preguntas sorprendido al ver un viejo conocido en este sitio.

 -¿Qué voy a hacer? Estar fresquito hombre. Ahí arriba hace 45 grados a la sombra, y en la plaza el sol achicharra a los incautos. ¿Has visto alguna vez ejecutar a alguno en la picota? Se churrascan como pollos asados, je, je, jeee.- rie el miserable dejando escapar el aire por su boca desdentada. -Además, aquí hay comida, ¿ves?- Añade mientras sacude delante de si una rata muerta empalada en un gancho.

[1] "Tengo que salir de aquí."
[2] Decir nada.

>acciones
Actions listing on.

>habla con hombre
[talking to Maddock]
[1] "Tengo que salir de aquí."
[2] Decir nada.

[talking to Maddock - succeeded]

* * *

>m
Huyendo por las alcantarillas
Las paredes se juntan con el techo abovedado. Rezuman limo, musgo y hongos. El fango ora te llega por los tobillos ora por las rodillas y todo huele de forma terriblemente espantosa. Y la penumbra no es tan densa como para evitarte ver todos los detalles desagradables. Hacia atrás está la vuelta a los pantanos y con ellos los trabajos forzados y la prisión. No los ves allá atrás, pero los policías con sus perros rastreadores no deben de andar muy lejos. Hacia adelante el túnel continúa y continúa.

>n
No sabes en qué dirección está el norte, el sur, o el oeste, sólo puedes ir hacia adelante o volver atrás.

>adelante
En mitad del túnel
La penumbra es menor aquí. Una rejilla anegada por la arena al final de una chimenea en el techo, que deja pasar algo de luz. El túnel continúa y continúa durante decenas de metros, sin ningún cambio de dirección, húmedo y apestoso, inmutable. Aunque a lo lejos se divisa el final.

-¡Crak, craaak!- un pájaro con las alas heridas agoniza en el fango.

>g
Final de las alcantarillas
El túnel termina aquí, en una sección cuadrada de la cual asciende una escalerilla metálica hacia la superficie.

En un receso de la pared hay sentado un ser andrajoso. Un hombre, o un despojo. Quemado por el sol, sucio pero de gesto constantemente feliz de ojos vidriosos rodeados de una maraña de pelo y barba de semanas, o meses.

>habla con hombre
El olor te asalta implacable. Corta la respiración y escuece en los ojos. Parecía imposible que algo en el mundo pudiese oler peor que las alcantarillas o que tu mismo, pero aquí está, lo tienes delante.

[1] "¿Qué haces aquí abajo?"
[2] Decir nada.

>1
-¡Maddock! ¿Qué haces aquí abajo? - preguntas sorprendido al ver un viejo conocido en este sitio.

 -¿Qué voy a hacer? Estar fresquito hombre. Ahí arriba hace 45 grados a la sombra, y en la plaza el sol achicharra a los incautos. ¿Has visto alguna vez ejecutar a alguno en la picota? Se churrascan como pollos asados, je, je, jeee.- rie el miserable dejando escapar el aire por su boca desdentada. -Además, aquí hay comida, ¿ves?- Añade mientras sacude delante de si una rata muerta empalada en un gancho.

[1] "Tengo que salir de aquí."
[2] Decir nada.

>1
-Tengo que seguir. - dices mirando atrás preocupado.

 -¿Vas a salir ahí arriba en pleno mediodía? ¿Es que no me has oído? ¡Ahí arriba se está a más de 50 grados a pleno sol! - te grita por primera vez sorprendido.

[1] "Tengo que encontrar a Isabelita."
[2] Decir nada.

>1
-Tengo que encontrar a Isabelita. ¿Sabes dónde está?- preguntas.

 -Sí hombre, no tiene pérdida, la encontrarás en "La luna ardiente"...- responde y este hecho parece divertirle mucho.

[1] "¡En el burdel!"
[2] Decir nada.

>1
-¡En el burdel! -Tomas a ese miserable por las raidas solapas.

 -¡Muah, ja, ja, jaaaa!- Este rie como un poseso. -Sí. Dicen que es casi tan popular como la sintética Hadaly. ¡Muah, ja, ja, jaaaggghrrj!

 Comienzas a estrangularle.

[1] "¡Te voy a matar!"
[2] Decir nada.

>1
-Te voy a matar.- gritas.

 -¡Espera! ¡Muah, ja, ja! Espera.- dice sin que la cara de diversión le cambie.

Levantas el puño dispuesto a partirle los pocos dientes que le quedan, pero su dedo te detiene, señala hacia el fondo del túnel:

 -¡Pero, oooh, oh, jo, jo! Más vale que te des prisa, sino no llegarás a hacer cola.- Señala divertido hacia el fondo del tunel. Allí se ven haces de linterna, se escuchan pasos en los charcos, gritos y ladridos. Es la policía. Están muy cerca.

>habla con hombre
El olor te asalta implacable. Corta la respiración y escuece en los ojos. Parecía imposible que algo en el mundo pudiese oler peor que las alcantarillas o que tu mismo, pero aquí está, lo tienes delante.

>matar maddock
La violencia no es la solución.

>atacar maddock
La violencia no es la solución.

>subir
Salida de las alcantarillas
Trepas como una exhalación las escalerillas metálicas hasta llegar a lo más alto. Y el aire cambia. La tapa de la alcantarilla irradia un calor abrasador que mantiene la humedad alejada.

Un rayo de luz cae verticalmente a través de un agujero en la tapa, calentando el aire a su paso.